prev_filename,filename,strType,xmin,ymin,xmax,ymax,labels,width,height,x_center,y_center,x_center_norm,y_center_norm,w_norm,h_norm
BloodImage_00000.jpg,0.jpg,WBC,260,177,491,376,2,231,199,375,276,0.5859375,0.575,0.3609375,0.41458333333333336
BloodImage_00000.jpg,0.jpg,RBC,78,336,184,435,1,106,99,131,385,0.2046875,0.8020833333333334,0.165625,0.20625
BloodImage_00000.jpg,0.jpg,RBC,63,237,169,336,1,106,99,116,286,0.18125,0.5958333333333333,0.165625,0.20625
BloodImage_00000.jpg,0.jpg,RBC,214,362,320,461,1,106,99,267,411,0.4171875,0.85625,0.165625,0.20625
BloodImage_00000.jpg,0.jpg,RBC,414,352,506,445,1,92,93,460,398,0.71875,0.8291666666666667,0.14375,0.19375
BloodImage_00000.jpg,0.jpg,RBC,555,356,640,455,1,85,99,597,405,0.9328125,0.84375,0.1328125,0.20625
BloodImage_00000.jpg,0.jpg,RBC,469,412,567,480,1,98,68,518,446,0.809375,0.9291666666666667,0.153125,0.14166666666666666
BloodImage_00000.jpg,0.jpg,RBC,1,333,87,437,1,86,104,44,385,0.06875,0.8020833333333334,0.134375,0.21666666666666667
BloodImage_00000.jpg,0.jpg,RBC,4,406,95,480,1,91,74,49,443,0.0765625,0.9229166666666667,0.1421875,0.15416666666666667
BloodImage_00000.jpg,0.jpg,RBC,155,74,247,174,1,92,100,201,124,0.3140625,0.25833333333333336,0.14375,0.20833333333333334
BloodImage_00000.jpg,0.jpg,RBC,11,84,104,162,1,93,78,57,123,0.0890625,0.25625,0.1453125,0.1625
BloodImage_00000.jpg,0.jpg,RBC,534,39,639,139,1,105,100,586,89,0.915625,0.18541666666666667,0.1640625,0.20833333333333334
BloodImage_00000.jpg,0.jpg,RBC,547,195,640,295,1,93,100,593,245,0.9265625,0.5104166666666666,0.1453125,0.20833333333333334
BloodImage_00000.jpg,0.jpg,RBC,388,11,481,111,1,93,100,434,61,0.678125,0.12708333333333333,0.1453125,0.20833333333333334
BloodImage_00000.jpg,0.jpg,RBC,171,175,264,275,1,93,100,217,225,0.3390625,0.46875,0.1453125,0.20833333333333334
BloodImage_00000.jpg,0.jpg,RBC,260,1,374,83,1,114,82,317,42,0.4953125,0.0875,0.178125,0.17083333333333334
BloodImage_00000.jpg,0.jpg,RBC,229,91,343,174,1,114,83,286,132,0.446875,0.275,0.178125,0.17291666666666666
BloodImage_00000.jpg,0.jpg,RBC,69,144,184,235,1,115,91,126,189,0.196875,0.39375,0.1796875,0.18958333333333333
BloodImage_00000.jpg,0.jpg,RBC,482,131,594,230,1,112,99,538,180,0.840625,0.375,0.175,0.20625
BloodImage_00000.jpg,0.jpg,RBC,368,89,464,176,1,96,87,416,132,0.65,0.275,0.15,0.18125
BloodImage_00001.jpg,1.jpg,WBC,68,315,286,480,2,218,165,177,397,0.2765625,0.8270833333333333,0.340625,0.34375
BloodImage_00001.jpg,1.jpg,RBC,346,361,446,454,1,100,93,396,407,0.61875,0.8479166666666667,0.15625,0.19375
BloodImage_00001.jpg,1.jpg,RBC,53,179,146,299,1,93,120,99,239,0.1546875,0.4979166666666667,0.1453125,0.25
BloodImage_00001.jpg,1.jpg,RBC,449,400,536,480,1,87,80,492,440,0.76875,0.9166666666666666,0.1359375,0.16666666666666666
BloodImage_00001.jpg,1.jpg,RBC,461,132,548,212,1,87,80,504,172,0.7875,0.35833333333333334,0.1359375,0.16666666666666666
BloodImage_00001.jpg,1.jpg,RBC,454,295,541,375,1,87,80,497,335,0.7765625,0.6979166666666666,0.1359375,0.16666666666666666
BloodImage_00001.jpg,1.jpg,RBC,417,283,508,383,1,91,100,462,333,0.721875,0.69375,0.1421875,0.20833333333333334
BloodImage_00001.jpg,1.jpg,RBC,278,342,369,451,1,91,109,323,396,0.5046875,0.825,0.1421875,0.22708333333333333
BloodImage_00001.jpg,1.jpg,RBC,545,62,636,159,1,91,97,590,110,0.921875,0.22916666666666666,0.1421875,0.20208333333333334
BloodImage_00001.jpg,1.jpg,RBC,485,91,576,188,1,91,97,530,139,0.828125,0.28958333333333336,0.1421875,0.20208333333333334
BloodImage_00001.jpg,1.jpg,RBC,376,171,438,253,1,62,82,407,212,0.6359375,0.44166666666666665,0.096875,0.17083333333333334
BloodImage_00001.jpg,1.jpg,RBC,329,177,395,271,1,66,94,362,224,0.565625,0.4666666666666667,0.103125,0.19583333333333333
BloodImage_00001.jpg,1.jpg,RBC,291,59,407,168,1,116,109,349,113,0.5453125,0.23541666666666666,0.18125,0.22708333333333333
BloodImage_00001.jpg,1.jpg,RBC,299,1,404,68,1,105,67,351,34,0.5484375,0.07083333333333333,0.1640625,0.13958333333333334
BloodImage_00001.jpg,1.jpg,RBC,346,26,449,138,1,103,112,397,82,0.6203125,0.17083333333333334,0.1609375,0.23333333333333334
BloodImage_00001.jpg,1.jpg,RBC,134,1,241,95,1,107,94,187,48,0.2921875,0.1,0.1671875,0.19583333333333333
BloodImage_00001.jpg,1.jpg,RBC,1,38,98,164,1,97,126,49,101,0.0765625,0.21041666666666667,0.1515625,0.2625
BloodImage_00001.jpg,1.jpg,RBC,165,160,257,264,1,92,104,211,212,0.3296875,0.44166666666666665,0.14375,0.21666666666666667
BloodImage_00001.jpg,1.jpg,RBC,464,209,566,319,1,102,110,515,264,0.8046875,0.55,0.159375,0.22916666666666666
BloodImage_00002.jpg,2.jpg,RBC,385,98,523,198,1,138,100,454,148,0.709375,0.30833333333333335,0.215625,0.20833333333333334
BloodImage_00002.jpg,2.jpg,RBC,384,164,499,260,1,115,96,441,212,0.6890625,0.44166666666666665,0.1796875,0.2
BloodImage_00002.jpg,2.jpg,RBC,101,120,224,222,1,123,102,162,171,0.253125,0.35625,0.1921875,0.2125
BloodImage_00002.jpg,2.jpg,RBC,130,344,234,443,1,104,99,182,393,0.284375,0.81875,0.1625,0.20625
BloodImage_00002.jpg,2.jpg,RBC,161,381,254,480,1,93,99,207,430,0.3234375,0.8958333333333334,0.1453125,0.20625
BloodImage_00002.jpg,2.jpg,RBC,14,228,123,344,1,109,116,68,286,0.10625,0.5958333333333333,0.1703125,0.24166666666666667
BloodImage_00002.jpg,2.jpg,RBC,306,293,415,409,1,109,116,360,351,0.5625,0.73125,0.1703125,0.24166666666666667
BloodImage_00002.jpg,2.jpg,RBC,531,103,632,221,1,101,118,581,162,0.9078125,0.3375,0.1578125,0.24583333333333332
BloodImage_00002.jpg,2.jpg,RBC,492,233,593,347,1,101,114,542,290,0.846875,0.6041666666666666,0.1578125,0.2375
BloodImage_00002.jpg,2.jpg,RBC,364,261,465,375,1,101,114,414,318,0.646875,0.6625,0.1578125,0.2375
BloodImage_00002.jpg,2.jpg,RBC,264,60,365,174,1,101,114,314,117,0.490625,0.24375,0.1578125,0.2375
BloodImage_00002.jpg,2.jpg,RBC,249,174,369,296,1,120,122,309,235,0.4828125,0.4895833333333333,0.1875,0.25416666666666665
BloodImage_00002.jpg,2.jpg,WBC,283,1,567,106,2,284,105,425,53,0.6640625,0.11041666666666666,0.44375,0.21875
BloodImage_00002.jpg,2.jpg,RBC,109,1,202,98,1,93,97,155,49,0.2421875,0.10208333333333333,0.1453125,0.20208333333333334
BloodImage_00002.jpg,2.jpg,RBC,135,66,228,164,1,93,98,181,115,0.2828125,0.23958333333333334,0.1453125,0.20416666666666666
BloodImage_00002.jpg,2.jpg,RBC,480,374,590,480,1,110,106,535,427,0.8359375,0.8895833333333333,0.171875,0.22083333333333333
BloodImage_00003.jpg,3.jpg,WBC,127,40,344,226,2,217,186,235,133,0.3671875,0.27708333333333335,0.3390625,0.3875
BloodImage_00003.jpg,3.jpg,RBC,317,93,424,195,1,107,102,370,144,0.578125,0.3,0.1671875,0.2125
BloodImage_00003.jpg,3.jpg,RBC,379,146,471,234,1,92,88,425,190,0.6640625,0.3958333333333333,0.14375,0.18333333333333332
BloodImage_00003.jpg,3.jpg,RBC,504,210,614,302,1,110,92,559,256,0.8734375,0.5333333333333333,0.171875,0.19166666666666668
BloodImage_00003.jpg,3.jpg,RBC,417,248,553,369,1,136,121,485,308,0.7578125,0.6416666666666667,0.2125,0.2520833333333333
BloodImage_00003.jpg,3.jpg,RBC,514,13,615,136,1,101,123,564,74,0.88125,0.15416666666666667,0.1578125,0.25625
BloodImage_00003.jpg,3.jpg,RBC,417,1,520,88,1,103,87,468,44,0.73125,0.09166666666666666,0.1609375,0.18125
BloodImage_00003.jpg,3.jpg,RBC,1,126,79,240,1,78,114,40,183,0.0625,0.38125,0.121875,0.2375
BloodImage_00003.jpg,3.jpg,RBC,47,202,158,317,1,111,115,102,259,0.159375,0.5395833333333333,0.1734375,0.23958333333333334
BloodImage_00003.jpg,3.jpg,RBC,314,284,424,377,1,110,93,369,330,0.5765625,0.6875,0.171875,0.19375
BloodImage_00003.jpg,3.jpg,RBC,365,350,484,451,1,119,101,424,400,0.6625,0.8333333333333334,0.1859375,0.21041666666666667
BloodImage_00003.jpg,3.jpg,RBC,1,347,86,434,1,85,87,43,390,0.0671875,0.8125,0.1328125,0.18125
BloodImage_00003.jpg,3.jpg,RBC,49,396,183,480,1,134,84,116,438,0.18125,0.9125,0.209375,0.175
BloodImage_00003.jpg,3.jpg,RBC,514,385,595,477,1,81,92,554,431,0.865625,0.8979166666666667,0.1265625,0.19166666666666668
BloodImage_00003.jpg,3.jpg,RBC,56,66,151,211,1,95,145,103,138,0.1609375,0.2875,0.1484375,0.3020833333333333
BloodImage_00003.jpg,3.jpg,RBC,213,253,333,368,1,120,115,273,310,0.4265625,0.6458333333333334,0.1875,0.23958333333333334
BloodImage_00003.jpg,3.jpg,Platelets,335,268,370,299,0,35,31,352,283,0.55,0.5895833333333333,0.0546875,0.06458333333333334
BloodImage_00004.jpg,4.jpg,WBC,109,134,324,321,2,215,187,216,227,0.3375,0.47291666666666665,0.3359375,0.38958333333333334
BloodImage_00004.jpg,4.jpg,RBC,432,242,528,325,1,96,83,480,283,0.75,0.5895833333333333,0.15,0.17291666666666666
BloodImage_00004.jpg,4.jpg,RBC,510,112,606,195,1,96,83,558,153,0.871875,0.31875,0.15,0.17291666666666666
BloodImage_00004.jpg,4.jpg,RBC,482,361,594,475,1,112,114,538,418,0.840625,0.8708333333333333,0.175,0.2375
BloodImage_00004.jpg,4.jpg,RBC,75,281,166,375,1,91,94,120,328,0.1875,0.6833333333333333,0.1421875,0.19583333333333333
BloodImage_00004.jpg,4.jpg,RBC,38,1,147,62,1,109,61,92,31,0.14375,0.06458333333333334,0.1703125,0.12708333333333333
BloodImage_00004.jpg,4.jpg,RBC,288,33,390,131,1,102,98,339,82,0.5296875,0.17083333333333334,0.159375,0.20416666666666666
BloodImage_00004.jpg,4.jpg,RBC,411,66,527,185,1,116,119,469,125,0.7328125,0.2604166666666667,0.18125,0.24791666666666667
BloodImage_00004.jpg,4.jpg,RBC,1,82,102,198,1,101,116,51,140,0.0796875,0.2916666666666667,0.1578125,0.24166666666666667
BloodImage_00004.jpg,4.jpg,RBC,1,283,81,372,1,80,89,41,327,0.0640625,0.68125,0.125,0.18541666666666667
BloodImage_00004.jpg,4.jpg,RBC,1,315,78,397,1,77,82,39,356,0.0609375,0.7416666666666667,0.1203125,0.17083333333333334
BloodImage_00004.jpg,4.jpg,RBC,391,373,469,455,1,78,82,430,414,0.671875,0.8625,0.121875,0.17083333333333334
BloodImage_00004.jpg,4.jpg,Platelets,127,47,163,81,0,36,34,145,64,0.2265625,0.13333333333333333,0.05625,0.07083333333333333
BloodImage_00005.jpg,5.jpg,RBC,273,115,386,222,1,113,107,329,168,0.5140625,0.35,0.1765625,0.22291666666666668
BloodImage_00005.jpg,5.jpg,RBC,56,103,169,210,1,113,107,112,156,0.175,0.325,0.1765625,0.22291666666666668
BloodImage_00005.jpg,5.jpg,RBC,414,42,518,170,1,104,128,466,106,0.728125,0.22083333333333333,0.1625,0.26666666666666666
BloodImage_00005.jpg,5.jpg,RBC,536,74,640,202,1,104,128,588,138,0.91875,0.2875,0.1625,0.26666666666666666
BloodImage_00005.jpg,5.jpg,RBC,474,193,578,321,1,104,128,526,257,0.821875,0.5354166666666667,0.1625,0.26666666666666666
BloodImage_00005.jpg,5.jpg,RBC,466,337,570,465,1,104,128,518,401,0.809375,0.8354166666666667,0.1625,0.26666666666666666
BloodImage_00005.jpg,5.jpg,RBC,420,352,524,480,1,104,128,472,416,0.7375,0.8666666666666667,0.1625,0.26666666666666666
BloodImage_00005.jpg,5.jpg,RBC,215,174,314,281,1,99,107,264,227,0.4125,0.47291666666666665,0.1546875,0.22291666666666668
BloodImage_00005.jpg,5.jpg,RBC,380,181,479,288,1,99,107,429,234,0.6703125,0.4875,0.1546875,0.22291666666666668
BloodImage_00005.jpg,5.jpg,RBC,1,64,99,171,1,98,107,50,117,0.078125,0.24375,0.153125,0.22291666666666668
BloodImage_00005.jpg,5.jpg,RBC,324,1,444,87,1,120,86,384,44,0.6,0.09166666666666666,0.1875,0.17916666666666667
BloodImage_00005.jpg,5.jpg,RBC,162,1,290,70,1,128,69,226,35,0.353125,0.07291666666666667,0.2,0.14375
BloodImage_00005.jpg,5.jpg,RBC,173,165,260,270,1,87,105,216,217,0.3375,0.45208333333333334,0.1359375,0.21875
BloodImage_00005.jpg,5.jpg,RBC,139,191,226,296,1,87,105,182,243,0.284375,0.50625,0.1359375,0.21875
BloodImage_00005.jpg,5.jpg,RBC,103,211,190,316,1,87,105,146,263,0.228125,0.5479166666666667,0.1359375,0.21875
BloodImage_00005.jpg,5.jpg,RBC,29,231,116,336,1,87,105,72,283,0.1125,0.5895833333333333,0.1359375,0.21875
BloodImage_00005.jpg,5.jpg,Platelets,170,65,207,100,0,37,35,188,82,0.29375,0.17083333333333334,0.0578125,0.07291666666666667
BloodImage_00005.jpg,5.jpg,Platelets,6,401,43,436,0,37,35,24,418,0.0375,0.8708333333333333,0.0578125,0.07291666666666667
BloodImage_00005.jpg,5.jpg,Platelets,124,305,161,340,0,37,35,142,322,0.221875,0.6708333333333333,0.0578125,0.07291666666666667
BloodImage_00005.jpg,5.jpg,WBC,230,288,441,480,2,211,192,335,384,0.5234375,0.8,0.3296875,0.4
BloodImage_00005.jpg,5.jpg,RBC,151,298,236,423,1,85,125,193,360,0.3015625,0.75,0.1328125,0.2604166666666667
BloodImage_00005.jpg,5.jpg,RBC,63,19,174,97,1,111,78,118,58,0.184375,0.12083333333333333,0.1734375,0.1625
BloodImage_00006.jpg,6.jpg,WBC,117,190,290,360,2,173,170,203,275,0.3171875,0.5729166666666666,0.2703125,0.3541666666666667
BloodImage_00006.jpg,6.jpg,Platelets,89,184,131,221,0,42,37,110,202,0.171875,0.42083333333333334,0.065625,0.07708333333333334
BloodImage_00006.jpg,6.jpg,Platelets,65,203,107,240,0,42,37,86,221,0.134375,0.46041666666666664,0.065625,0.07708333333333334
BloodImage_00006.jpg,6.jpg,Platelets,333,1,372,30,0,39,29,352,15,0.55,0.03125,0.0609375,0.06041666666666667
BloodImage_00006.jpg,6.jpg,RBC,79,357,202,459,1,123,102,140,408,0.21875,0.85,0.1921875,0.2125
BloodImage_00006.jpg,6.jpg,RBC,495,1,620,114,1,125,113,557,57,0.8703125,0.11875,0.1953125,0.23541666666666666
BloodImage_00006.jpg,6.jpg,RBC,353,327,476,463,1,123,136,414,395,0.646875,0.8229166666666666,0.1921875,0.2833333333333333
BloodImage_00006.jpg,6.jpg,RBC,449,319,565,393,1,116,74,507,356,0.7921875,0.7416666666666667,0.18125,0.15416666666666667
BloodImage_00006.jpg,6.jpg,RBC,291,104,403,194,1,112,90,347,149,0.5421875,0.3104166666666667,0.175,0.1875
BloodImage_00006.jpg,6.jpg,RBC,211,76,323,166,1,112,90,267,121,0.4171875,0.2520833333333333,0.175,0.1875
BloodImage_00006.jpg,6.jpg,RBC,207,350,319,440,1,112,90,263,395,0.4109375,0.8229166666666666,0.175,0.1875
BloodImage_00006.jpg,6.jpg,RBC,253,298,371,403,1,118,105,312,350,0.4875,0.7291666666666666,0.184375,0.21875
BloodImage_00006.jpg,6.jpg,RBC,546,368,639,480,1,93,112,592,424,0.925,0.8833333333333333,0.1453125,0.23333333333333334
BloodImage_00006.jpg,6.jpg,RBC,482,223,617,327,1,135,104,549,275,0.8578125,0.5729166666666666,0.2109375,0.21666666666666667
BloodImage_00006.jpg,6.jpg,RBC,503,160,619,246,1,116,86,561,203,0.8765625,0.42291666666666666,0.18125,0.17916666666666667
BloodImage_00006.jpg,6.jpg,RBC,373,142,489,235,1,116,93,431,188,0.6734375,0.39166666666666666,0.18125,0.19375
BloodImage_00006.jpg,6.jpg,RBC,108,121,235,216,1,127,95,171,168,0.2671875,0.35,0.1984375,0.19791666666666666
BloodImage_00006.jpg,6.jpg,RBC,16,59,143,154,1,127,95,79,106,0.1234375,0.22083333333333333,0.1984375,0.19791666666666666
BloodImage_00007.jpg,7.jpg,WBC,193,92,387,285,2,194,193,290,188,0.453125,0.39166666666666666,0.303125,0.40208333333333335
BloodImage_00007.jpg,7.jpg,RBC,17,298,134,402,1,117,104,75,350,0.1171875,0.7291666666666666,0.1828125,0.21666666666666667
BloodImage_00007.jpg,7.jpg,RBC,64,372,175,479,1,111,107,119,425,0.1859375,0.8854166666666666,0.1734375,0.22291666666666668
BloodImage_00007.jpg,7.jpg,RBC,119,330,230,437,1,111,107,174,383,0.271875,0.7979166666666667,0.1734375,0.22291666666666668
BloodImage_00007.jpg,7.jpg,RBC,169,265,259,374,1,90,109,214,319,0.334375,0.6645833333333333,0.140625,0.22708333333333333
BloodImage_00007.jpg,7.jpg,RBC,191,291,281,400,1,90,109,236,345,0.36875,0.71875,0.140625,0.22708333333333333
BloodImage_00007.jpg,7.jpg,RBC,213,305,303,414,1,90,109,258,359,0.403125,0.7479166666666667,0.140625,0.22708333333333333
BloodImage_00007.jpg,7.jpg,RBC,247,315,337,424,1,90,109,292,369,0.45625,0.76875,0.140625,0.22708333333333333
BloodImage_00007.jpg,7.jpg,RBC,495,300,601,402,1,106,102,548,351,0.85625,0.73125,0.165625,0.2125
BloodImage_00007.jpg,7.jpg,RBC,534,371,640,473,1,106,102,587,422,0.9171875,0.8791666666666667,0.165625,0.2125
BloodImage_00007.jpg,7.jpg,RBC,510,7,616,109,1,106,102,563,58,0.8796875,0.12083333333333333,0.165625,0.2125
BloodImage_00007.jpg,7.jpg,RBC,515,44,639,152,1,124,108,577,98,0.9015625,0.20416666666666666,0.19375,0.225
BloodImage_00007.jpg,7.jpg,RBC,18,124,142,232,1,124,108,80,178,0.125,0.37083333333333335,0.19375,0.225
BloodImage_00007.jpg,7.jpg,RBC,70,63,194,171,1,124,108,132,117,0.20625,0.24375,0.19375,0.225
BloodImage_00007.jpg,7.jpg,RBC,19,29,143,137,1,124,108,81,83,0.1265625,0.17291666666666666,0.19375,0.225
BloodImage_00007.jpg,7.jpg,RBC,270,1,392,71,1,122,70,331,36,0.5171875,0.075,0.190625,0.14583333333333334
BloodImage_00007.jpg,7.jpg,RBC,254,427,340,480,1,86,53,297,453,0.4640625,0.94375,0.134375,0.11041666666666666
BloodImage_00007.jpg,7.jpg,RBC,298,434,381,480,1,83,46,339,457,0.5296875,0.9520833333333333,0.1296875,0.09583333333333334
BloodImage_00008.jpg,8.jpg,WBC,42,183,277,381,2,235,198,159,282,0.2484375,0.5875,0.3671875,0.4125
BloodImage_00008.jpg,8.jpg,RBC,398,222,519,330,1,121,108,458,276,0.715625,0.575,0.1890625,0.225
BloodImage_00008.jpg,8.jpg,RBC,505,103,626,211,1,121,108,565,157,0.8828125,0.32708333333333334,0.1890625,0.225
BloodImage_00008.jpg,8.jpg,RBC,366,315,472,413,1,106,98,419,364,0.6546875,0.7583333333333333,0.165625,0.20416666666666666
BloodImage_00008.jpg,8.jpg,RBC,456,312,562,410,1,106,98,509,361,0.7953125,0.7520833333333333,0.165625,0.20416666666666666
BloodImage_00008.jpg,8.jpg,RBC,524,250,630,348,1,106,98,577,299,0.9015625,0.6229166666666667,0.165625,0.20416666666666666
BloodImage_00008.jpg,8.jpg,RBC,534,335,640,433,1,106,98,587,384,0.9171875,0.8,0.165625,0.20416666666666666
BloodImage_00008.jpg,8.jpg,RBC,353,43,459,141,1,106,98,406,92,0.634375,0.19166666666666668,0.165625,0.20416666666666666
BloodImage_00008.jpg,8.jpg,RBC,316,43,422,141,1,106,98,369,92,0.5765625,0.19166666666666668,0.165625,0.20416666666666666
BloodImage_00008.jpg,8.jpg,RBC,265,25,371,123,1,106,98,318,74,0.496875,0.15416666666666667,0.165625,0.20416666666666666
BloodImage_00008.jpg,8.jpg,RBC,221,18,327,116,1,106,98,274,67,0.428125,0.13958333333333334,0.165625,0.20416666666666666
BloodImage_00008.jpg,8.jpg,RBC,109,1,221,85,1,112,84,165,43,0.2578125,0.08958333333333333,0.175,0.175
BloodImage_00008.jpg,8.jpg,RBC,1,166,96,299,1,95,133,48,232,0.075,0.48333333333333334,0.1484375,0.27708333333333335
BloodImage_00008.jpg,8.jpg,RBC,263,402,365,480,1,102,78,314,441,0.490625,0.91875,0.159375,0.1625
BloodImage_00008.jpg,8.jpg,RBC,178,402,280,480,1,102,78,229,441,0.3578125,0.91875,0.159375,0.1625
BloodImage_00008.jpg,8.jpg,RBC,1,1,102,77,1,101,76,51,39,0.0796875,0.08125,0.1578125,0.15833333333333333
BloodImage_00008.jpg,8.jpg,RBC,196,135,313,215,1,117,80,254,175,0.396875,0.3645833333333333,0.1828125,0.16666666666666666
BloodImage_00008.jpg,8.jpg,RBC,447,392,607,480,1,160,88,527,436,0.8234375,0.9083333333333333,0.25,0.18333333333333332
BloodImage_00008.jpg,8.jpg,RBC,148,62,234,172,1,86,110,191,117,0.2984375,0.24375,0.134375,0.22916666666666666
BloodImage_00008.jpg,8.jpg,RBC,438,1,564,85,1,126,84,501,43,0.7828125,0.08958333333333333,0.196875,0.175
BloodImage_00009.jpg,9.jpg,WBC,23,137,255,423,2,232,286,139,280,0.2171875,0.5833333333333334,0.3625,0.5958333333333333
BloodImage_00009.jpg,9.jpg,RBC,441,324,575,423,1,134,99,508,373,0.79375,0.7770833333333333,0.209375,0.20625
BloodImage_00009.jpg,9.jpg,RBC,372,192,468,279,1,96,87,420,235,0.65625,0.4895833333333333,0.15,0.18125
BloodImage_00009.jpg,9.jpg,RBC,305,213,401,300,1,96,87,353,256,0.5515625,0.5333333333333333,0.15,0.18125
BloodImage_00009.jpg,9.jpg,RBC,226,288,324,439,1,98,151,275,363,0.4296875,0.75625,0.153125,0.3145833333333333
BloodImage_00009.jpg,9.jpg,RBC,313,318,408,414,1,95,96,360,366,0.5625,0.7625,0.1484375,0.2
BloodImage_00009.jpg,9.jpg,RBC,282,384,377,480,1,95,96,329,432,0.5140625,0.9,0.1484375,0.2
BloodImage_00009.jpg,9.jpg,RBC,446,97,567,206,1,121,109,506,151,0.790625,0.3145833333333333,0.1890625,0.22708333333333333
BloodImage_00009.jpg,9.jpg,RBC,440,1,561,96,1,121,95,500,48,0.78125,0.1,0.1890625,0.19791666666666666
BloodImage_00009.jpg,9.jpg,RBC,214,107,331,198,1,117,91,272,152,0.425,0.31666666666666665,0.1828125,0.18958333333333333
BloodImage_00009.jpg,9.jpg,RBC,298,85,435,211,1,137,126,366,148,0.571875,0.30833333333333335,0.2140625,0.2625
BloodImage_00009.jpg,9.jpg,RBC,7,76,133,197,1,126,121,70,136,0.109375,0.2833333333333333,0.196875,0.2520833333333333
BloodImage_00009.jpg,9.jpg,RBC,1,1,115,94,1,114,93,58,47,0.090625,0.09791666666666667,0.178125,0.19375
BloodImage_00009.jpg,9.jpg,RBC,286,1,394,65,1,108,64,340,33,0.53125,0.06875,0.16875,0.13333333333333333
BloodImage_00009.jpg,9.jpg,RBC,154,13,289,127,1,135,114,221,70,0.3453125,0.14583333333333334,0.2109375,0.2375
BloodImage_00009.jpg,9.jpg,Platelets,452,415,493,449,0,41,34,472,432,0.7375,0.9,0.0640625,0.07083333333333333
BloodImage_00009.jpg,9.jpg,RBC,479,155,575,242,1,96,87,527,198,0.8234375,0.4125,0.15,0.18125
BloodImage_00009.jpg,9.jpg,RBC,135,393,231,480,1,96,87,183,436,0.2859375,0.9083333333333333,0.15,0.18125
BloodImage_00010.jpg,10.jpg,WBC,23,229,204,421,2,181,192,113,325,0.1765625,0.6770833333333334,0.2828125,0.4
BloodImage_00010.jpg,10.jpg,WBC,239,253,510,470,2,271,217,374,361,0.584375,0.7520833333333333,0.4234375,0.45208333333333334
BloodImage_00010.jpg,10.jpg,RBC,167,212,269,331,1,102,119,218,271,0.340625,0.5645833333333333,0.159375,0.24791666666666667
BloodImage_00010.jpg,10.jpg,RBC,69,138,170,243,1,101,105,119,190,0.1859375,0.3958333333333333,0.1578125,0.21875
BloodImage_00010.jpg,10.jpg,RBC,43,84,126,171,1,83,87,84,127,0.13125,0.26458333333333334,0.1296875,0.18125
BloodImage_00010.jpg,10.jpg,RBC,275,166,358,253,1,83,87,316,209,0.49375,0.4354166666666667,0.1296875,0.18125
BloodImage_00010.jpg,10.jpg,RBC,311,179,394,266,1,83,87,352,222,0.55,0.4625,0.1296875,0.18125
BloodImage_00010.jpg,10.jpg,RBC,267,69,350,156,1,83,87,308,112,0.48125,0.23333333333333334,0.1296875,0.18125
BloodImage_00010.jpg,10.jpg,RBC,307,75,390,162,1,83,87,348,118,0.54375,0.24583333333333332,0.1296875,0.18125
BloodImage_00010.jpg,10.jpg,RBC,339,80,422,167,1,83,87,380,123,0.59375,0.25625,0.1296875,0.18125
BloodImage_00010.jpg,10.jpg,RBC,456,1,550,68,1,94,67,503,34,0.7859375,0.07083333333333333,0.146875,0.13958333333333334
BloodImage_00010.jpg,10.jpg,RBC,314,1,429,69,1,115,68,371,35,0.5796875,0.07291666666666667,0.1796875,0.14166666666666666
BloodImage_00010.jpg,10.jpg,RBC,200,1,310,43,1,110,42,255,22,0.3984375,0.04583333333333333,0.171875,0.0875
BloodImage_00010.jpg,10.jpg,RBC,16,1,100,79,1,84,78,58,40,0.090625,0.08333333333333333,0.13125,0.1625
BloodImage_00010.jpg,10.jpg,RBC,406,80,538,185,1,132,105,472,132,0.7375,0.275,0.20625,0.21875
BloodImage_00010.jpg,10.jpg,RBC,560,236,640,345,1,80,109,600,290,0.9375,0.6041666666666666,0.125,0.22708333333333333
BloodImage_00010.jpg,10.jpg,RBC,571,174,640,260,1,69,86,605,217,0.9453125,0.45208333333333334,0.1078125,0.17916666666666667
BloodImage_00010.jpg,10.jpg,RBC,566,76,640,160,1,74,84,603,118,0.9421875,0.24583333333333332,0.115625,0.175
BloodImage_00011.jpg,11.jpg,WBC,109,119,304,332,2,195,213,206,225,0.321875,0.46875,0.3046875,0.44375
BloodImage_00011.jpg,11.jpg,RBC,364,201,453,279,1,89,78,408,240,0.6375,0.5,0.1390625,0.1625
BloodImage_00011.jpg,11.jpg,RBC,416,167,505,245,1,89,78,460,206,0.71875,0.42916666666666664,0.1390625,0.1625
BloodImage_00011.jpg,11.jpg,RBC,459,111,548,189,1,89,78,503,150,0.7859375,0.3125,0.1390625,0.1625
BloodImage_00011.jpg,11.jpg,RBC,462,142,551,240,1,89,98,506,191,0.790625,0.39791666666666664,0.1390625,0.20416666666666666
BloodImage_00011.jpg,11.jpg,RBC,505,163,576,240,1,71,77,540,201,0.84375,0.41875,0.1109375,0.16041666666666668
BloodImage_00011.jpg,11.jpg,RBC,476,235,583,332,1,107,97,529,283,0.8265625,0.5895833333333333,0.1671875,0.20208333333333334
BloodImage_00011.jpg,11.jpg,RBC,14,296,117,409,1,103,113,65,352,0.1015625,0.7333333333333333,0.1609375,0.23541666666666666
BloodImage_00011.jpg,11.jpg,RBC,220,8,313,112,1,93,104,266,60,0.415625,0.125,0.1453125,0.21666666666666667
BloodImage_00011.jpg,11.jpg,RBC,342,48,435,152,1,93,104,388,100,0.60625,0.20833333333333334,0.1453125,0.21666666666666667
BloodImage_00011.jpg,11.jpg,RBC,317,74,434,180,1,117,106,375,127,0.5859375,0.26458333333333334,0.1828125,0.22083333333333333
BloodImage_00011.jpg,11.jpg,RBC,258,79,352,171,1,94,92,305,125,0.4765625,0.2604166666666667,0.146875,0.19166666666666668
BloodImage_00011.jpg,11.jpg,RBC,404,291,498,394,1,94,103,451,342,0.7046875,0.7125,0.146875,0.21458333333333332
BloodImage_00011.jpg,11.jpg,RBC,199,337,293,440,1,94,103,246,388,0.384375,0.8083333333333333,0.146875,0.21458333333333332
BloodImage_00011.jpg,11.jpg,RBC,85,372,211,477,1,126,105,148,424,0.23125,0.8833333333333333,0.196875,0.21875
BloodImage_00011.jpg,11.jpg,RBC,104,1,212,117,1,108,116,158,59,0.246875,0.12291666666666666,0.16875,0.24166666666666667
BloodImage_00011.jpg,11.jpg,Platelets,85,153,122,196,0,37,43,103,174,0.1609375,0.3625,0.0578125,0.08958333333333333
BloodImage_00011.jpg,11.jpg,RBC,262,419,354,480,1,92,61,308,449,0.48125,0.9354166666666667,0.14375,0.12708333333333333
BloodImage_00011.jpg,11.jpg,RBC,1,77,94,180,1,93,103,47,128,0.0734375,0.26666666666666666,0.1453125,0.21458333333333332
BloodImage_00012.jpg,12.jpg,WBC,2,187,228,359,2,226,172,115,273,0.1796875,0.56875,0.353125,0.35833333333333334
BloodImage_00012.jpg,12.jpg,RBC,349,146,475,240,1,126,94,412,193,0.64375,0.40208333333333335,0.196875,0.19583333333333333
BloodImage_00012.jpg,12.jpg,RBC,377,210,483,314,1,106,104,430,262,0.671875,0.5458333333333333,0.165625,0.21666666666666667
BloodImage_00012.jpg,12.jpg,RBC,401,299,507,403,1,106,104,454,351,0.709375,0.73125,0.165625,0.21666666666666667
BloodImage_00012.jpg,12.jpg,RBC,296,281,386,387,1,90,106,341,334,0.5328125,0.6958333333333333,0.140625,0.22083333333333333
BloodImage_00012.jpg,12.jpg,RBC,251,311,344,439,1,93,128,297,375,0.4640625,0.78125,0.1453125,0.26666666666666666
BloodImage_00012.jpg,12.jpg,RBC,168,304,264,402,1,96,98,216,353,0.3375,0.7354166666666667,0.15,0.20416666666666666
BloodImage_00012.jpg,12.jpg,RBC,14,335,125,434,1,111,99,69,384,0.1078125,0.8,0.1734375,0.20625
BloodImage_00012.jpg,12.jpg,RBC,126,393,251,479,1,125,86,188,436,0.29375,0.9083333333333333,0.1953125,0.17916666666666667
BloodImage_00012.jpg,12.jpg,RBC,329,376,412,477,1,83,101,370,426,0.578125,0.8875,0.1296875,0.21041666666666667
BloodImage_00012.jpg,12.jpg,RBC,519,356,622,455,1,103,99,570,405,0.890625,0.84375,0.1609375,0.20625
BloodImage_00012.jpg,12.jpg,RBC,476,257,579,356,1,103,99,527,306,0.8234375,0.6375,0.1609375,0.20625
BloodImage_00012.jpg,12.jpg,RBC,489,193,592,292,1,103,99,540,242,0.84375,0.5041666666666667,0.1609375,0.20625
BloodImage_00012.jpg,12.jpg,RBC,564,232,640,328,1,76,96,602,280,0.940625,0.5833333333333334,0.11875,0.2
BloodImage_00012.jpg,12.jpg,Platelets,417,403,463,440,0,46,37,440,421,0.6875,0.8770833333333333,0.071875,0.07708333333333334
BloodImage_00012.jpg,12.jpg,Platelets,351,44,397,81,0,46,37,374,62,0.584375,0.12916666666666668,0.071875,0.07708333333333334
BloodImage_00012.jpg,12.jpg,RBC,220,20,303,107,1,83,87,261,63,0.4078125,0.13125,0.1296875,0.18125
BloodImage_00012.jpg,12.jpg,RBC,495,82,605,204,1,110,122,550,143,0.859375,0.29791666666666666,0.171875,0.25416666666666665
BloodImage_00012.jpg,12.jpg,RBC,299,431,381,480,1,82,49,340,455,0.53125,0.9479166666666666,0.128125,0.10208333333333333
BloodImage_00013.jpg,13.jpg,WBC,31,208,238,406,2,207,198,134,307,0.209375,0.6395833333333333,0.3234375,0.4125
BloodImage_00013.jpg,13.jpg,RBC,255,283,371,392,1,116,109,313,337,0.4890625,0.7020833333333333,0.18125,0.22708333333333333
BloodImage_00013.jpg,13.jpg,RBC,405,288,517,420,1,112,132,461,354,0.7203125,0.7375,0.175,0.275
BloodImage_00013.jpg,13.jpg,RBC,369,77,486,223,1,117,146,427,150,0.6671875,0.3125,0.1828125,0.30416666666666664
BloodImage_00013.jpg,13.jpg,RBC,90,98,200,189,1,110,91,145,143,0.2265625,0.29791666666666666,0.171875,0.18958333333333333
BloodImage_00013.jpg,13.jpg,RBC,203,365,313,456,1,110,91,258,410,0.403125,0.8541666666666666,0.171875,0.18958333333333333
BloodImage_00013.jpg,13.jpg,RBC,318,396,427,480,1,109,84,372,438,0.58125,0.9125,0.1703125,0.175
BloodImage_00013.jpg,13.jpg,RBC,574,160,639,281,1,65,121,606,220,0.946875,0.4583333333333333,0.1015625,0.2520833333333333
BloodImage_00013.jpg,13.jpg,RBC,466,57,564,174,1,98,117,515,115,0.8046875,0.23958333333333334,0.153125,0.24375
BloodImage_00013.jpg,13.jpg,RBC,547,48,638,144,1,91,96,592,96,0.925,0.2,0.1421875,0.2
BloodImage_00013.jpg,13.jpg,RBC,500,214,599,325,1,99,111,549,269,0.8578125,0.5604166666666667,0.1546875,0.23125
BloodImage_00013.jpg,13.jpg,RBC,184,12,299,118,1,115,106,241,65,0.3765625,0.13541666666666666,0.1796875,0.22083333333333333
BloodImage_00013.jpg,13.jpg,RBC,105,34,220,140,1,115,106,162,87,0.253125,0.18125,0.1796875,0.22083333333333333
BloodImage_00013.jpg,13.jpg,RBC,455,404,555,480,1,100,76,505,442,0.7890625,0.9208333333333333,0.15625,0.15833333333333333
BloodImage_00013.jpg,13.jpg,RBC,324,402,424,478,1,100,76,374,440,0.584375,0.9166666666666666,0.15625,0.15833333333333333
BloodImage_00014.jpg,14.jpg,WBC,236,211,379,353,2,143,142,307,282,0.4796875,0.5875,0.2234375,0.29583333333333334
BloodImage_00014.jpg,14.jpg,RBC,158,140,258,234,1,100,94,208,187,0.325,0.38958333333333334,0.15625,0.19583333333333333
BloodImage_00014.jpg,14.jpg,RBC,78,334,197,435,1,119,101,137,384,0.2140625,0.8,0.1859375,0.21041666666666667
BloodImage_00014.jpg,14.jpg,RBC,1,137,72,242,1,71,105,36,189,0.05625,0.39375,0.1109375,0.21875
BloodImage_00014.jpg,14.jpg,RBC,33,89,152,189,1,119,100,92,139,0.14375,0.28958333333333336,0.1859375,0.20833333333333334
BloodImage_00014.jpg,14.jpg,RBC,53,15,172,115,1,119,100,112,65,0.175,0.13541666666666666,0.1859375,0.20833333333333334
BloodImage_00014.jpg,14.jpg,RBC,336,1,406,93,1,70,92,371,47,0.5796875,0.09791666666666667,0.109375,0.19166666666666668
BloodImage_00014.jpg,14.jpg,RBC,297,78,422,173,1,125,95,359,125,0.5609375,0.2604166666666667,0.1953125,0.19791666666666666
BloodImage_00014.jpg,14.jpg,RBC,224,76,352,191,1,128,115,288,133,0.45,0.27708333333333335,0.2,0.23958333333333334
BloodImage_00014.jpg,14.jpg,RBC,215,380,334,480,1,119,100,274,430,0.428125,0.8958333333333334,0.1859375,0.20833333333333334
BloodImage_00014.jpg,14.jpg,RBC,356,303,447,393,1,91,90,401,348,0.6265625,0.725,0.1421875,0.1875
BloodImage_00014.jpg,14.jpg,RBC,393,215,484,305,1,91,90,438,260,0.684375,0.5416666666666666,0.1421875,0.1875
BloodImage_00014.jpg,14.jpg,RBC,448,406,545,480,1,97,74,496,443,0.775,0.9229166666666667,0.1515625,0.15416666666666667
BloodImage_00014.jpg,14.jpg,RBC,431,1,554,102,1,123,101,492,51,0.76875,0.10625,0.1921875,0.21041666666666667
BloodImage_00014.jpg,14.jpg,Platelets,362,389,405,428,0,43,39,383,408,0.5984375,0.85,0.0671875,0.08125
BloodImage_00014.jpg,14.jpg,Platelets,233,340,276,379,0,43,39,254,359,0.396875,0.7479166666666667,0.0671875,0.08125
BloodImage_00014.jpg,14.jpg,RBC,542,289,630,399,1,88,110,586,344,0.915625,0.7166666666666667,0.1375,0.22916666666666666
BloodImage_00014.jpg,14.jpg,RBC,579,131,640,236,1,61,105,609,183,0.9515625,0.38125,0.0953125,0.21875
BloodImage_00014.jpg,14.jpg,RBC,525,70,618,176,1,93,106,571,123,0.8921875,0.25625,0.1453125,0.22083333333333333
BloodImage_00015.jpg,15.jpg,WBC,145,4,361,240,2,216,236,253,122,0.3953125,0.25416666666666665,0.3375,0.49166666666666664
BloodImage_00015.jpg,15.jpg,RBC,353,135,428,232,1,75,97,390,183,0.609375,0.38125,0.1171875,0.20208333333333334
BloodImage_00015.jpg,15.jpg,RBC,354,12,448,128,1,94,116,401,70,0.6265625,0.14583333333333334,0.146875,0.24166666666666667
BloodImage_00015.jpg,15.jpg,RBC,440,78,540,160,1,100,82,490,119,0.765625,0.24791666666666667,0.15625,0.17083333333333334
BloodImage_00015.jpg,15.jpg,RBC,537,47,638,144,1,101,97,587,95,0.9171875,0.19791666666666666,0.1578125,0.20208333333333334
BloodImage_00015.jpg,15.jpg,RBC,435,1,538,75,1,103,74,486,38,0.759375,0.07916666666666666,0.1609375,0.15416666666666667
BloodImage_00015.jpg,15.jpg,RBC,411,359,522,459,1,111,100,466,409,0.728125,0.8520833333333333,0.1734375,0.20833333333333334
BloodImage_00015.jpg,15.jpg,RBC,266,409,374,480,1,108,71,320,444,0.5,0.925,0.16875,0.14791666666666667
BloodImage_00015.jpg,15.jpg,RBC,1,396,134,480,1,133,84,67,438,0.1046875,0.9125,0.2078125,0.175
BloodImage_00015.jpg,15.jpg,RBC,1,272,102,379,1,101,107,51,325,0.0796875,0.6770833333333334,0.1578125,0.22291666666666668
BloodImage_00015.jpg,15.jpg,RBC,62,62,165,169,1,103,107,113,115,0.1765625,0.23958333333333334,0.1609375,0.22291666666666668
BloodImage_00015.jpg,15.jpg,RBC,248,201,351,308,1,103,107,299,254,0.4671875,0.5291666666666667,0.1609375,0.22291666666666668
BloodImage_00015.jpg,15.jpg,RBC,91,300,204,391,1,113,91,147,345,0.2296875,0.71875,0.1765625,0.18958333333333333
BloodImage_00015.jpg,15.jpg,RBC,564,140,640,240,1,76,100,602,190,0.940625,0.3958333333333333,0.11875,0.20833333333333334
BloodImage_00015.jpg,15.jpg,Platelets,291,373,337,410,0,46,37,314,391,0.490625,0.8145833333333333,0.071875,0.07708333333333334
BloodImage_00015.jpg,15.jpg,RBC,373,202,484,302,1,111,100,428,252,0.66875,0.525,0.1734375,0.20833333333333334
BloodImage_00016.jpg,16.jpg,WBC,151,118,329,279,2,178,161,240,198,0.375,0.4125,0.278125,0.33541666666666664
BloodImage_00016.jpg,16.jpg,RBC,121,323,242,440,1,121,117,181,381,0.2828125,0.79375,0.1890625,0.24375
BloodImage_00016.jpg,16.jpg,RBC,324,115,418,236,1,94,121,371,175,0.5796875,0.3645833333333333,0.146875,0.2520833333333333
BloodImage_00016.jpg,16.jpg,RBC,450,329,542,442,1,92,113,496,385,0.775,0.8020833333333334,0.14375,0.23541666666666666
BloodImage_00016.jpg,16.jpg,RBC,427,364,519,477,1,92,113,473,420,0.7390625,0.875,0.14375,0.23541666666666666
BloodImage_00016.jpg,16.jpg,RBC,230,333,346,449,1,116,116,288,391,0.45,0.8145833333333333,0.18125,0.24166666666666667
BloodImage_00016.jpg,16.jpg,RBC,448,91,549,168,1,101,77,498,129,0.778125,0.26875,0.1578125,0.16041666666666668
BloodImage_00016.jpg,16.jpg,RBC,570,290,640,403,1,70,113,605,346,0.9453125,0.7208333333333333,0.109375,0.23541666666666666
BloodImage_00016.jpg,16.jpg,RBC,523,69,637,174,1,114,105,580,121,0.90625,0.2520833333333333,0.178125,0.21875
BloodImage_00016.jpg,16.jpg,RBC,334,219,451,337,1,117,118,392,278,0.6125,0.5791666666666667,0.1828125,0.24583333333333332
BloodImage_00016.jpg,16.jpg,RBC,449,227,566,345,1,117,118,507,286,0.7921875,0.5958333333333333,0.1828125,0.24583333333333332
BloodImage_00016.jpg,16.jpg,RBC,66,155,160,276,1,94,121,113,215,0.1765625,0.4479166666666667,0.146875,0.2520833333333333
BloodImage_00016.jpg,16.jpg,Platelets,97,327,129,365,0,32,38,113,346,0.1765625,0.7208333333333333,0.05,0.07916666666666666
BloodImage_00017.jpg,17.jpg,WBC,128,215,336,391,2,208,176,232,303,0.3625,0.63125,0.325,0.36666666666666664
BloodImage_00017.jpg,17.jpg,RBC,406,176,514,272,1,108,96,460,224,0.71875,0.4666666666666667,0.16875,0.2
BloodImage_00017.jpg,17.jpg,RBC,400,73,510,181,1,110,108,455,127,0.7109375,0.26458333333333334,0.171875,0.225
BloodImage_00017.jpg,17.jpg,RBC,215,87,299,187,1,84,100,257,137,0.4015625,0.28541666666666665,0.13125,0.20833333333333334
BloodImage_00017.jpg,17.jpg,RBC,435,302,547,400,1,112,98,491,351,0.7671875,0.73125,0.175,0.20416666666666666
BloodImage_00017.jpg,17.jpg,RBC,424,354,536,452,1,112,98,480,403,0.75,0.8395833333333333,0.175,0.20416666666666666
BloodImage_00017.jpg,17.jpg,RBC,131,382,235,470,1,104,88,183,426,0.2859375,0.8875,0.1625,0.18333333333333332
BloodImage_00017.jpg,17.jpg,RBC,481,164,585,252,1,104,88,533,208,0.8328125,0.43333333333333335,0.1625,0.18333333333333332
BloodImage_00017.jpg,17.jpg,RBC,5,335,102,434,1,97,99,53,384,0.0828125,0.8,0.1515625,0.20625
BloodImage_00017.jpg,17.jpg,RBC,1,101,53,205,1,52,104,27,153,0.0421875,0.31875,0.08125,0.21666666666666667
BloodImage_00017.jpg,17.jpg,RBC,221,390,340,464,1,119,74,280,427,0.4375,0.8895833333333333,0.1859375,0.15416666666666667
BloodImage_00017.jpg,17.jpg,RBC,156,1,260,84,1,104,83,208,42,0.325,0.0875,0.1625,0.17291666666666666
BloodImage_00017.jpg,17.jpg,RBC,279,37,381,145,1,102,108,330,91,0.515625,0.18958333333333333,0.159375,0.225
BloodImage_00017.jpg,17.jpg,RBC,528,1,621,87,1,93,86,574,44,0.896875,0.09166666666666666,0.1453125,0.17916666666666667
BloodImage_00017.jpg,17.jpg,RBC,488,11,581,98,1,93,87,534,54,0.834375,0.1125,0.1453125,0.18125
BloodImage_00017.jpg,17.jpg,RBC,4,245,106,353,1,102,108,55,299,0.0859375,0.6229166666666667,0.159375,0.225
BloodImage_00017.jpg,17.jpg,RBC,322,335,424,443,1,102,108,373,389,0.5828125,0.8104166666666667,0.159375,0.225
BloodImage_00017.jpg,17.jpg,Platelets,382,47,419,79,0,37,32,400,63,0.625,0.13125,0.0578125,0.06666666666666667
BloodImage_00018.jpg,18.jpg,WBC,302,1,481,166,2,179,165,391,83,0.6109375,0.17291666666666666,0.2796875,0.34375
BloodImage_00018.jpg,18.jpg,RBC,167,100,307,197,1,140,97,237,148,0.3703125,0.30833333333333335,0.21875,0.20208333333333334
BloodImage_00018.jpg,18.jpg,RBC,210,1,319,64,1,109,63,264,32,0.4125,0.06666666666666667,0.1703125,0.13125
BloodImage_00018.jpg,18.jpg,RBC,561,74,639,183,1,78,109,600,128,0.9375,0.26666666666666666,0.121875,0.22708333333333333
BloodImage_00018.jpg,18.jpg,RBC,130,26,230,125,1,100,99,180,75,0.28125,0.15625,0.15625,0.20625
BloodImage_00018.jpg,18.jpg,RBC,74,189,164,277,1,90,88,119,233,0.1859375,0.48541666666666666,0.140625,0.18333333333333332
BloodImage_00018.jpg,18.jpg,RBC,304,162,394,250,1,90,88,349,206,0.5453125,0.42916666666666664,0.140625,0.18333333333333332
BloodImage_00018.jpg,18.jpg,RBC,363,163,453,251,1,90,88,408,207,0.6375,0.43125,0.140625,0.18333333333333332
BloodImage_00018.jpg,18.jpg,RBC,410,152,500,240,1,90,88,455,196,0.7109375,0.4083333333333333,0.140625,0.18333333333333332
BloodImage_00018.jpg,18.jpg,RBC,430,131,520,219,1,90,88,475,175,0.7421875,0.3645833333333333,0.140625,0.18333333333333332
BloodImage_00018.jpg,18.jpg,RBC,483,109,573,197,1,90,88,528,153,0.825,0.31875,0.140625,0.18333333333333332
BloodImage_00018.jpg,18.jpg,RBC,541,276,631,364,1,90,88,586,320,0.915625,0.6666666666666666,0.140625,0.18333333333333332
BloodImage_00018.jpg,18.jpg,RBC,572,181,640,287,1,68,106,606,234,0.946875,0.4875,0.10625,0.22083333333333333
BloodImage_00018.jpg,18.jpg,RBC,286,424,375,480,1,89,56,330,452,0.515625,0.9416666666666667,0.1390625,0.11666666666666667
BloodImage_00018.jpg,18.jpg,RBC,308,240,421,325,1,113,85,364,282,0.56875,0.5875,0.1765625,0.17708333333333334
BloodImage_00018.jpg,18.jpg,RBC,189,345,278,423,1,89,78,233,384,0.3640625,0.8,0.1390625,0.1625
BloodImage_00018.jpg,18.jpg,RBC,1,213,89,340,1,88,127,45,276,0.0703125,0.575,0.1375,0.26458333333333334
BloodImage_00018.jpg,18.jpg,RBC,67,324,182,447,1,115,123,124,385,0.19375,0.8020833333333334,0.1796875,0.25625
BloodImage_00018.jpg,18.jpg,RBC,17,45,131,168,1,114,123,74,106,0.115625,0.22083333333333333,0.178125,0.25625
BloodImage_00018.jpg,18.jpg,RBC,21,1,114,86,1,93,85,67,43,0.1046875,0.08958333333333333,0.1453125,0.17708333333333334
BloodImage_00018.jpg,18.jpg,RBC,243,189,333,277,1,90,88,288,233,0.45,0.48541666666666666,0.140625,0.18333333333333332
BloodImage_00018.jpg,18.jpg,RBC,241,259,331,347,1,90,88,286,303,0.446875,0.63125,0.140625,0.18333333333333332
BloodImage_00019.jpg,19.jpg,WBC,107,97,295,267,2,188,170,201,182,0.3140625,0.37916666666666665,0.29375,0.3541666666666667
BloodImage_00019.jpg,19.jpg,RBC,41,158,126,280,1,85,122,83,219,0.1296875,0.45625,0.1328125,0.25416666666666665
BloodImage_00019.jpg,19.jpg,RBC,410,315,513,430,1,103,115,461,372,0.7203125,0.775,0.1609375,0.23958333333333334
BloodImage_00019.jpg,19.jpg,RBC,524,332,627,447,1,103,115,575,389,0.8984375,0.8104166666666667,0.1609375,0.23958333333333334
BloodImage_00019.jpg,19.jpg,RBC,461,348,564,463,1,103,115,512,405,0.8,0.84375,0.1609375,0.23958333333333334
BloodImage_00019.jpg,19.jpg,RBC,227,398,343,480,1,116,82,285,439,0.4453125,0.9145833333333333,0.18125,0.17083333333333334
BloodImage_00019.jpg,19.jpg,RBC,133,398,249,480,1,116,82,191,439,0.2984375,0.9145833333333333,0.18125,0.17083333333333334
BloodImage_00019.jpg,19.jpg,RBC,125,366,241,448,1,116,82,183,407,0.2859375,0.8479166666666667,0.18125,0.17083333333333334
BloodImage_00019.jpg,19.jpg,RBC,373,150,476,243,1,103,93,424,196,0.6625,0.4083333333333333,0.1609375,0.19375
BloodImage_00019.jpg,19.jpg,RBC,492,196,595,289,1,103,93,543,242,0.8484375,0.5041666666666667,0.1609375,0.19375
BloodImage_00019.jpg,19.jpg,RBC,297,201,428,315,1,131,114,362,258,0.565625,0.5375,0.2046875,0.2375
BloodImage_00019.jpg,19.jpg,RBC,532,48,615,142,1,83,94,573,95,0.8953125,0.19791666666666666,0.1296875,0.19583333333333333
BloodImage_00019.jpg,19.jpg,RBC,1,122,56,255,1,55,133,28,188,0.04375,0.39166666666666666,0.0859375,0.27708333333333335
BloodImage_00019.jpg,19.jpg,RBC,88,1,237,93,1,149,92,162,47,0.253125,0.09791666666666667,0.2328125,0.19166666666666668
BloodImage_00019.jpg,19.jpg,RBC,231,251,317,336,1,86,85,274,293,0.428125,0.6104166666666667,0.134375,0.17708333333333334
BloodImage_00019.jpg,19.jpg,RBC,164,284,270,376,1,106,92,217,330,0.3390625,0.6875,0.165625,0.19166666666666668
BloodImage_00019.jpg,19.jpg,RBC,320,133,423,226,1,103,93,371,179,0.5796875,0.3729166666666667,0.1609375,0.19375
BloodImage_00020.jpg,20.jpg,Platelets,419,189,478,236,0,59,47,448,212,0.7,0.44166666666666665,0.0921875,0.09791666666666667
BloodImage_00020.jpg,20.jpg,WBC,352,364,475,447,2,123,83,413,405,0.6453125,0.84375,0.1921875,0.17291666666666666
BloodImage_00020.jpg,20.jpg,RBC,226,99,333,206,1,107,107,279,152,0.4359375,0.31666666666666665,0.1671875,0.22291666666666668
BloodImage_00020.jpg,20.jpg,RBC,404,25,511,132,1,107,107,457,78,0.7140625,0.1625,0.1671875,0.22291666666666668
BloodImage_00020.jpg,20.jpg,RBC,511,38,618,145,1,107,107,564,91,0.88125,0.18958333333333333,0.1671875,0.22291666666666668
BloodImage_00020.jpg,20.jpg,RBC,457,206,564,313,1,107,107,510,259,0.796875,0.5395833333333333,0.1671875,0.22291666666666668
BloodImage_00020.jpg,20.jpg,RBC,478,370,585,477,1,107,107,531,423,0.8296875,0.88125,0.1671875,0.22291666666666668
BloodImage_00020.jpg,20.jpg,RBC,287,238,394,345,1,107,107,340,291,0.53125,0.60625,0.1671875,0.22291666666666668
BloodImage_00020.jpg,20.jpg,Platelets,372,343,406,374,0,34,31,389,358,0.6078125,0.7458333333333333,0.053125,0.06458333333333334
BloodImage_00020.jpg,20.jpg,RBC,40,277,147,384,1,107,107,93,330,0.1453125,0.6875,0.1671875,0.22291666666666668
BloodImage_00020.jpg,20.jpg,RBC,1,277,79,379,1,78,102,40,328,0.0625,0.6833333333333333,0.121875,0.2125
BloodImage_00020.jpg,20.jpg,RBC,80,166,187,273,1,107,107,133,219,0.2078125,0.45625,0.1671875,0.22291666666666668
BloodImage_00020.jpg,20.jpg,RBC,143,245,250,352,1,107,107,196,298,0.30625,0.6208333333333333,0.1671875,0.22291666666666668
BloodImage_00020.jpg,20.jpg,RBC,144,366,251,473,1,107,107,197,419,0.3078125,0.8729166666666667,0.1671875,0.22291666666666668
BloodImage_00020.jpg,20.jpg,RBC,142,364,249,471,1,107,107,195,417,0.3046875,0.86875,0.1671875,0.22291666666666668
BloodImage_00020.jpg,20.jpg,RBC,109,41,216,148,1,107,107,162,94,0.253125,0.19583333333333333,0.1671875,0.22291666666666668
BloodImage_00020.jpg,20.jpg,RBC,460,59,567,166,1,107,107,513,112,0.8015625,0.23333333333333334,0.1671875,0.22291666666666668
BloodImage_00020.jpg,20.jpg,RBC,570,256,640,357,1,70,101,605,306,0.9453125,0.6375,0.109375,0.21041666666666667
BloodImage_00020.jpg,20.jpg,RBC,61,383,169,480,1,108,97,115,431,0.1796875,0.8979166666666667,0.16875,0.20208333333333334
BloodImage_00020.jpg,20.jpg,RBC,1,128,106,235,1,105,107,53,181,0.0828125,0.3770833333333333,0.1640625,0.22291666666666668
BloodImage_00020.jpg,20.jpg,RBC,40,1,149,95,1,109,94,94,48,0.146875,0.1,0.1703125,0.19583333333333333
BloodImage_00020.jpg,20.jpg,RBC,165,1,274,95,1,109,94,219,48,0.3421875,0.1,0.1703125,0.19583333333333333
BloodImage_00020.jpg,20.jpg,Platelets,80,128,115,161,0,35,33,97,144,0.1515625,0.3,0.0546875,0.06875
BloodImage_00021.jpg,21.jpg,WBC,330,302,494,438,2,164,136,412,370,0.64375,0.7708333333333334,0.25625,0.2833333333333333
BloodImage_00021.jpg,21.jpg,Platelets,375,103,422,146,0,47,43,398,124,0.621875,0.25833333333333336,0.0734375,0.08958333333333333
BloodImage_00021.jpg,21.jpg,Platelets,483,184,530,227,0,47,43,506,205,0.790625,0.4270833333333333,0.0734375,0.08958333333333333
BloodImage_00021.jpg,21.jpg,RBC,363,141,483,255,1,120,114,423,198,0.6609375,0.4125,0.1875,0.2375
BloodImage_00021.jpg,21.jpg,RBC,274,161,394,275,1,120,114,334,218,0.521875,0.45416666666666666,0.1875,0.2375
BloodImage_00021.jpg,21.jpg,RBC,215,219,335,333,1,120,114,275,276,0.4296875,0.575,0.1875,0.2375
BloodImage_00021.jpg,21.jpg,RBC,97,335,217,449,1,120,114,157,392,0.2453125,0.8166666666666667,0.1875,0.2375
BloodImage_00021.jpg,21.jpg,RBC,5,262,125,376,1,120,114,65,319,0.1015625,0.6645833333333333,0.1875,0.2375
BloodImage_00021.jpg,21.jpg,RBC,50,229,170,343,1,120,114,110,286,0.171875,0.5958333333333333,0.1875,0.2375
BloodImage_00021.jpg,21.jpg,RBC,1,102,104,197,1,103,95,52,149,0.08125,0.3104166666666667,0.1609375,0.19791666666666666
BloodImage_00021.jpg,21.jpg,RBC,72,98,176,193,1,104,95,124,145,0.19375,0.3020833333333333,0.1625,0.19791666666666666
BloodImage_00021.jpg,21.jpg,RBC,521,109,625,204,1,104,95,573,156,0.8953125,0.325,0.1625,0.19791666666666666
BloodImage_00021.jpg,21.jpg,RBC,581,100,640,194,1,59,94,610,147,0.953125,0.30625,0.0921875,0.19583333333333333
BloodImage_00021.jpg,21.jpg,RBC,378,1,475,76,1,97,75,426,38,0.665625,0.07916666666666666,0.1515625,0.15625
BloodImage_00021.jpg,21.jpg,RBC,209,1,318,111,1,109,110,263,56,0.4109375,0.11666666666666667,0.1703125,0.22916666666666666
BloodImage_00021.jpg,21.jpg,RBC,117,1,207,87,1,90,86,162,44,0.253125,0.09166666666666666,0.140625,0.17916666666666667
BloodImage_00021.jpg,21.jpg,RBC,568,347,639,461,1,71,114,603,404,0.9421875,0.8416666666666667,0.1109375,0.2375
BloodImage_00021.jpg,21.jpg,RBC,168,84,288,198,1,120,114,228,141,0.35625,0.29375,0.1875,0.2375
BloodImage_00021.jpg,21.jpg,RBC,221,361,341,475,1,120,114,281,418,0.4390625,0.8708333333333333,0.1875,0.2375
BloodImage_00022.jpg,22.jpg,WBC,108,194,281,372,2,173,178,194,283,0.303125,0.5895833333333333,0.2703125,0.37083333333333335
BloodImage_00022.jpg,22.jpg,Platelets,99,329,138,360,0,39,31,118,344,0.184375,0.7166666666666667,0.0609375,0.06458333333333334
BloodImage_00022.jpg,22.jpg,Platelets,149,1,188,30,0,39,29,168,15,0.2625,0.03125,0.0609375,0.06041666666666667
BloodImage_00022.jpg,22.jpg,Platelets,394,199,433,230,0,39,31,413,214,0.6453125,0.44583333333333336,0.0609375,0.06458333333333334
BloodImage_00022.jpg,22.jpg,RBC,17,163,130,255,1,113,92,73,209,0.1140625,0.4354166666666667,0.1765625,0.19166666666666668
BloodImage_00022.jpg,22.jpg,RBC,1,197,113,289,1,112,92,57,243,0.0890625,0.50625,0.175,0.19166666666666668
BloodImage_00022.jpg,22.jpg,RBC,289,142,392,234,1,103,92,340,188,0.53125,0.39166666666666666,0.1609375,0.19166666666666668
BloodImage_00022.jpg,22.jpg,RBC,340,81,443,173,1,103,92,391,127,0.6109375,0.26458333333333334,0.1609375,0.19166666666666668
BloodImage_00022.jpg,22.jpg,RBC,275,22,392,126,1,117,104,333,74,0.5203125,0.15416666666666667,0.1828125,0.21666666666666667
BloodImage_00022.jpg,22.jpg,RBC,441,59,579,163,1,138,104,510,111,0.796875,0.23125,0.215625,0.21666666666666667
BloodImage_00022.jpg,22.jpg,RBC,471,143,579,263,1,108,120,525,203,0.8203125,0.42291666666666666,0.16875,0.25
BloodImage_00022.jpg,22.jpg,RBC,557,359,639,480,1,82,121,598,419,0.934375,0.8729166666666667,0.128125,0.2520833333333333
BloodImage_00022.jpg,22.jpg,RBC,406,374,538,480,1,132,106,472,427,0.7375,0.8895833333333333,0.20625,0.22083333333333333
BloodImage_00022.jpg,22.jpg,RBC,272,389,389,480,1,117,91,330,434,0.515625,0.9041666666666667,0.1828125,0.18958333333333333
BloodImage_00022.jpg,22.jpg,RBC,378,249,482,349,1,104,100,430,299,0.671875,0.6229166666666667,0.1625,0.20833333333333334
BloodImage_00022.jpg,22.jpg,RBC,15,12,100,147,1,85,135,57,79,0.0890625,0.16458333333333333,0.1328125,0.28125
BloodImage_00023.jpg,23.jpg,WBC,98,34,281,206,2,183,172,189,120,0.2953125,0.25,0.2859375,0.35833333333333334
BloodImage_00023.jpg,23.jpg,RBC,277,113,387,233,1,110,120,332,173,0.51875,0.36041666666666666,0.171875,0.25
BloodImage_00023.jpg,23.jpg,RBC,388,82,498,202,1,110,120,443,142,0.6921875,0.29583333333333334,0.171875,0.25
BloodImage_00023.jpg,23.jpg,RBC,306,243,416,363,1,110,120,361,303,0.5640625,0.63125,0.171875,0.25
BloodImage_00023.jpg,23.jpg,RBC,186,268,291,381,1,105,113,238,324,0.371875,0.675,0.1640625,0.23541666666666666
BloodImage_00023.jpg,23.jpg,RBC,296,364,423,480,1,127,116,359,422,0.5609375,0.8791666666666667,0.1984375,0.24166666666666667
BloodImage_00023.jpg,23.jpg,RBC,511,147,638,263,1,127,116,574,205,0.896875,0.4270833333333333,0.1984375,0.24166666666666667
BloodImage_00023.jpg,23.jpg,RBC,62,414,174,480,1,112,66,118,447,0.184375,0.93125,0.175,0.1375
BloodImage_00023.jpg,23.jpg,RBC,37,1,141,76,1,104,75,89,38,0.1390625,0.07916666666666666,0.1625,0.15625
BloodImage_00023.jpg,23.jpg,RBC,29,152,117,247,1,88,95,73,199,0.1140625,0.41458333333333336,0.1375,0.19791666666666666
BloodImage_00023.jpg,23.jpg,RBC,494,1,594,74,1,100,73,544,37,0.85,0.07708333333333334,0.15625,0.15208333333333332
BloodImage_00023.jpg,23.jpg,RBC,572,264,640,345,1,68,81,606,304,0.946875,0.6333333333333333,0.10625,0.16875
BloodImage_00023.jpg,23.jpg,RBC,524,354,640,453,1,116,99,582,403,0.909375,0.8395833333333333,0.18125,0.20625
BloodImage_00023.jpg,23.jpg,RBC,15,220,109,334,1,94,114,62,277,0.096875,0.5770833333333333,0.146875,0.2375
BloodImage_00023.jpg,23.jpg,Platelets,132,292,171,340,0,39,48,151,316,0.2359375,0.6583333333333333,0.0609375,0.1
BloodImage_00023.jpg,23.jpg,RBC,343,1,468,110,1,125,109,405,55,0.6328125,0.11458333333333333,0.1953125,0.22708333333333333
BloodImage_00023.jpg,23.jpg,RBC,209,245,305,327,1,96,82,257,286,0.4015625,0.5958333333333333,0.15,0.17083333333333334
BloodImage_00023.jpg,23.jpg,RBC,177,219,273,301,1,96,82,225,260,0.3515625,0.5416666666666666,0.15,0.17083333333333334
BloodImage_00024.jpg,24.jpg,WBC,310,1,471,128,2,161,127,390,64,0.609375,0.13333333333333333,0.2515625,0.26458333333333334
BloodImage_00024.jpg,24.jpg,RBC,89,89,192,206,1,103,117,140,147,0.21875,0.30625,0.1609375,0.24375
BloodImage_00024.jpg,24.jpg,RBC,265,114,368,231,1,103,117,316,172,0.49375,0.35833333333333334,0.1609375,0.24375
BloodImage_00024.jpg,24.jpg,RBC,203,176,295,318,1,92,142,249,247,0.3890625,0.5145833333333333,0.14375,0.29583333333333334
BloodImage_00024.jpg,24.jpg,RBC,109,195,204,306,1,95,111,156,250,0.24375,0.5208333333333334,0.1484375,0.23125
BloodImage_00024.jpg,24.jpg,RBC,391,117,486,228,1,95,111,438,172,0.684375,0.35833333333333334,0.1484375,0.23125
BloodImage_00024.jpg,24.jpg,RBC,376,250,471,361,1,95,111,423,305,0.6609375,0.6354166666666666,0.1484375,0.23125
BloodImage_00024.jpg,24.jpg,RBC,314,357,419,477,1,105,120,366,417,0.571875,0.86875,0.1640625,0.25
BloodImage_00024.jpg,24.jpg,RBC,25,309,142,428,1,117,119,83,368,0.1296875,0.7666666666666667,0.1828125,0.24791666666666667
BloodImage_00024.jpg,24.jpg,RBC,497,1,604,97,1,107,96,550,49,0.859375,0.10208333333333333,0.1671875,0.2
BloodImage_00024.jpg,24.jpg,RBC,578,144,640,248,1,62,104,609,196,0.9515625,0.4083333333333333,0.096875,0.21666666666666667
BloodImage_00024.jpg,24.jpg,RBC,570,252,640,390,1,70,138,605,321,0.9453125,0.66875,0.109375,0.2875
BloodImage_00024.jpg,24.jpg,RBC,494,325,588,427,1,94,102,541,376,0.8453125,0.7833333333333333,0.146875,0.2125
BloodImage_00024.jpg,24.jpg,RBC,399,334,517,457,1,118,123,458,395,0.715625,0.8229166666666666,0.184375,0.25625
BloodImage_00024.jpg,24.jpg,RBC,19,234,103,344,1,84,110,61,289,0.0953125,0.6020833333333333,0.13125,0.22916666666666666
BloodImage_00024.jpg,24.jpg,RBC,484,196,587,313,1,103,117,535,254,0.8359375,0.5291666666666667,0.1609375,0.24375
BloodImage_00026.jpg,25.jpg,WBC,387,1,564,102,2,177,101,475,51,0.7421875,0.10625,0.2765625,0.21041666666666667
BloodImage_00026.jpg,25.jpg,RBC,178,2,287,113,1,109,111,232,57,0.3625,0.11875,0.1703125,0.23125
BloodImage_00026.jpg,25.jpg,RBC,114,154,223,265,1,109,111,168,209,0.2625,0.4354166666666667,0.1703125,0.23125
BloodImage_00026.jpg,25.jpg,RBC,102,60,211,171,1,109,111,156,115,0.24375,0.23958333333333334,0.1703125,0.23125
BloodImage_00026.jpg,25.jpg,RBC,42,70,151,181,1,109,111,96,125,0.15,0.2604166666666667,0.1703125,0.23125
BloodImage_00026.jpg,25.jpg,RBC,1,112,94,227,1,93,115,47,169,0.0734375,0.35208333333333336,0.1453125,0.23958333333333334
BloodImage_00026.jpg,25.jpg,RBC,2,171,113,287,1,111,116,57,229,0.0890625,0.47708333333333336,0.1734375,0.24166666666666667
BloodImage_00026.jpg,25.jpg,RBC,424,270,535,386,1,111,116,479,328,0.7484375,0.6833333333333333,0.1734375,0.24166666666666667
BloodImage_00026.jpg,25.jpg,RBC,173,362,282,460,1,109,98,227,411,0.3546875,0.85625,0.1703125,0.20416666666666666
BloodImage_00026.jpg,25.jpg,RBC,86,358,195,456,1,109,98,140,407,0.21875,0.8479166666666667,0.1703125,0.20416666666666666
BloodImage_00026.jpg,25.jpg,RBC,253,151,350,245,1,97,94,301,198,0.4703125,0.4125,0.1515625,0.19583333333333333
BloodImage_00026.jpg,25.jpg,RBC,497,196,608,294,1,111,98,552,245,0.8625,0.5104166666666666,0.1734375,0.20416666666666666
BloodImage_00026.jpg,25.jpg,RBC,317,351,426,471,1,109,120,371,411,0.5796875,0.85625,0.1703125,0.25
BloodImage_00026.jpg,25.jpg,RBC,202,280,329,394,1,127,114,265,337,0.4140625,0.7020833333333333,0.1984375,0.2375
BloodImage_00026.jpg,25.jpg,RBC,295,202,422,316,1,127,114,358,259,0.559375,0.5395833333333333,0.1984375,0.2375
BloodImage_00026.jpg,25.jpg,RBC,436,94,574,210,1,138,116,505,152,0.7890625,0.31666666666666665,0.215625,0.24166666666666667
BloodImage_00026.jpg,25.jpg,RBC,294,78,407,194,1,113,116,350,136,0.546875,0.2833333333333333,0.1765625,0.24166666666666667
BloodImage_00026.jpg,25.jpg,Platelets,146,269,186,304,0,40,35,166,286,0.259375,0.5958333333333333,0.0625,0.07291666666666667
BloodImage_00026.jpg,25.jpg,Platelets,282,425,322,460,0,40,35,302,442,0.471875,0.9208333333333333,0.0625,0.07291666666666667
BloodImage_00028.jpg,26.jpg,WBC,255,1,430,160,2,175,159,342,80,0.534375,0.16666666666666666,0.2734375,0.33125
BloodImage_00028.jpg,26.jpg,RBC,224,177,316,272,1,92,95,270,224,0.421875,0.4666666666666667,0.14375,0.19791666666666666
BloodImage_00028.jpg,26.jpg,RBC,328,290,431,391,1,103,101,379,340,0.5921875,0.7083333333333334,0.1609375,0.21041666666666667
BloodImage_00028.jpg,26.jpg,RBC,203,308,306,409,1,103,101,254,358,0.396875,0.7458333333333333,0.1609375,0.21041666666666667
BloodImage_00028.jpg,26.jpg,RBC,1,281,107,404,1,106,123,54,342,0.084375,0.7125,0.165625,0.25625
BloodImage_00028.jpg,26.jpg,RBC,143,118,250,241,1,107,123,196,179,0.30625,0.3729166666666667,0.1671875,0.25625
BloodImage_00028.jpg,26.jpg,RBC,1,98,70,217,1,69,119,35,157,0.0546875,0.32708333333333334,0.1078125,0.24791666666666667
BloodImage_00028.jpg,26.jpg,RBC,1,185,82,272,1,81,87,41,228,0.0640625,0.475,0.1265625,0.18125
BloodImage_00028.jpg,26.jpg,RBC,89,243,171,330,1,82,87,130,286,0.203125,0.5958333333333333,0.128125,0.18125
BloodImage_00028.jpg,26.jpg,RBC,129,409,246,480,1,117,71,187,444,0.2921875,0.925,0.1828125,0.14791666666666667
BloodImage_00028.jpg,26.jpg,RBC,166,221,269,322,1,103,101,217,271,0.3390625,0.5645833333333333,0.1609375,0.21041666666666667
BloodImage_00028.jpg,26.jpg,RBC,119,1,220,68,1,101,67,169,34,0.2640625,0.07083333333333333,0.1578125,0.13958333333333334
BloodImage_00028.jpg,26.jpg,RBC,192,1,272,60,1,80,59,232,30,0.3625,0.0625,0.125,0.12291666666666666
BloodImage_00028.jpg,26.jpg,RBC,387,167,491,266,1,104,99,439,216,0.6859375,0.45,0.1625,0.20625
BloodImage_00028.jpg,26.jpg,RBC,441,195,505,267,1,64,72,473,231,0.7390625,0.48125,0.1,0.15
BloodImage_00028.jpg,26.jpg,RBC,553,181,639,285,1,86,104,596,233,0.93125,0.48541666666666666,0.134375,0.21666666666666667
BloodImage_00028.jpg,26.jpg,RBC,534,228,620,332,1,86,104,577,280,0.9015625,0.5833333333333334,0.134375,0.21666666666666667
BloodImage_00028.jpg,26.jpg,RBC,553,362,639,480,1,86,118,596,421,0.93125,0.8770833333333333,0.134375,0.24583333333333332
BloodImage_00028.jpg,26.jpg,RBC,553,1,640,104,1,87,103,596,52,0.93125,0.10833333333333334,0.1359375,0.21458333333333332
BloodImage_00028.jpg,26.jpg,RBC,462,58,583,190,1,121,132,522,124,0.815625,0.25833333333333336,0.1890625,0.275
BloodImage_00028.jpg,26.jpg,RBC,385,75,501,181,1,116,106,443,128,0.6921875,0.26666666666666666,0.18125,0.22083333333333333
BloodImage_00028.jpg,26.jpg,RBC,266,328,388,450,1,122,122,327,389,0.5109375,0.8104166666666667,0.190625,0.25416666666666665
BloodImage_00029.jpg,27.jpg,WBC,75,179,224,315,2,149,136,149,247,0.2328125,0.5145833333333333,0.2328125,0.2833333333333333
BloodImage_00029.jpg,27.jpg,Platelets,440,283,495,317,0,55,34,467,300,0.7296875,0.625,0.0859375,0.07083333333333333
BloodImage_00029.jpg,27.jpg,RBC,241,86,358,199,1,117,113,299,142,0.4671875,0.29583333333333334,0.1828125,0.23541666666666666
BloodImage_00029.jpg,27.jpg,RBC,212,48,293,142,1,81,94,252,95,0.39375,0.19791666666666666,0.1265625,0.19583333333333333
BloodImage_00029.jpg,27.jpg,RBC,364,143,463,228,1,99,85,413,185,0.6453125,0.3854166666666667,0.1546875,0.17708333333333334
BloodImage_00029.jpg,27.jpg,RBC,424,137,545,228,1,121,91,484,182,0.75625,0.37916666666666665,0.1890625,0.18958333333333333
BloodImage_00029.jpg,27.jpg,RBC,227,193,348,300,1,121,107,287,246,0.4484375,0.5125,0.1890625,0.22291666666666668
BloodImage_00029.jpg,27.jpg,RBC,207,265,328,372,1,121,107,267,318,0.4171875,0.6625,0.1890625,0.22291666666666668
BloodImage_00029.jpg,27.jpg,RBC,139,320,260,427,1,121,107,199,373,0.3109375,0.7770833333333333,0.1890625,0.22291666666666668
BloodImage_00029.jpg,27.jpg,RBC,256,365,377,472,1,121,107,316,418,0.49375,0.8708333333333333,0.1890625,0.22291666666666668
BloodImage_00029.jpg,27.jpg,RBC,390,356,511,463,1,121,107,450,409,0.703125,0.8520833333333333,0.1890625,0.22291666666666668
BloodImage_00029.jpg,27.jpg,RBC,506,110,624,196,1,118,86,565,153,0.8828125,0.31875,0.184375,0.17916666666666667
BloodImage_00029.jpg,27.jpg,RBC,517,57,638,148,1,121,91,577,102,0.9015625,0.2125,0.1890625,0.18958333333333333
BloodImage_00029.jpg,27.jpg,RBC,421,8,526,107,1,105,99,473,57,0.7390625,0.11875,0.1640625,0.20625
BloodImage_00029.jpg,27.jpg,RBC,70,23,200,145,1,130,122,135,84,0.2109375,0.175,0.203125,0.25416666666666665
BloodImage_00029.jpg,27.jpg,RBC,19,70,129,186,1,110,116,74,128,0.115625,0.26666666666666666,0.171875,0.24166666666666667
BloodImage_00029.jpg,27.jpg,RBC,1,128,87,251,1,86,123,44,189,0.06875,0.39375,0.134375,0.25625
BloodImage_00029.jpg,27.jpg,RBC,1,194,79,318,1,78,124,40,256,0.0625,0.5333333333333333,0.121875,0.25833333333333336
BloodImage_00029.jpg,27.jpg,RBC,1,264,75,366,1,74,102,38,315,0.059375,0.65625,0.115625,0.2125
BloodImage_00029.jpg,27.jpg,RBC,1,310,75,412,1,74,102,38,361,0.059375,0.7520833333333333,0.115625,0.2125
BloodImage_00029.jpg,27.jpg,RBC,24,355,105,459,1,81,104,64,407,0.1,0.8479166666666667,0.1265625,0.21666666666666667
BloodImage_00029.jpg,27.jpg,RBC,11,423,103,480,1,92,57,57,451,0.0890625,0.9395833333333333,0.14375,0.11875
BloodImage_00029.jpg,27.jpg,RBC,207,1,300,51,1,93,50,253,26,0.3953125,0.05416666666666667,0.1453125,0.10416666666666667
BloodImage_00029.jpg,27.jpg,RBC,275,1,365,74,1,90,73,320,37,0.5,0.07708333333333334,0.140625,0.15208333333333332
BloodImage_00030.jpg,28.jpg,WBC,1,191,143,333,2,142,142,72,262,0.1125,0.5458333333333333,0.221875,0.29583333333333334
BloodImage_00030.jpg,28.jpg,RBC,123,249,230,370,1,107,121,176,309,0.275,0.64375,0.1671875,0.2520833333333333
BloodImage_00030.jpg,28.jpg,RBC,149,113,229,219,1,80,106,189,166,0.2953125,0.3458333333333333,0.125,0.22083333333333333
BloodImage_00030.jpg,28.jpg,RBC,198,117,278,223,1,80,106,238,170,0.371875,0.3541666666666667,0.125,0.22083333333333333
BloodImage_00030.jpg,28.jpg,RBC,195,58,264,144,1,69,86,229,101,0.3578125,0.21041666666666667,0.1078125,0.17916666666666667
BloodImage_00030.jpg,28.jpg,RBC,291,270,383,377,1,92,107,337,323,0.5265625,0.6729166666666667,0.14375,0.22291666666666668
BloodImage_00030.jpg,28.jpg,RBC,324,402,429,480,1,105,78,376,441,0.5875,0.91875,0.1640625,0.1625
BloodImage_00030.jpg,28.jpg,RBC,359,402,464,480,1,105,78,411,441,0.6421875,0.91875,0.1640625,0.1625
BloodImage_00030.jpg,28.jpg,RBC,375,239,472,340,1,97,101,423,289,0.6609375,0.6020833333333333,0.1515625,0.21041666666666667
BloodImage_00030.jpg,28.jpg,RBC,457,191,554,292,1,97,101,505,241,0.7890625,0.5020833333333333,0.1515625,0.21041666666666667
BloodImage_00030.jpg,28.jpg,RBC,299,174,415,277,1,116,103,357,225,0.5578125,0.46875,0.18125,0.21458333333333332
BloodImage_00030.jpg,28.jpg,RBC,458,387,556,480,1,98,93,507,433,0.7921875,0.9020833333333333,0.153125,0.19375
BloodImage_00030.jpg,28.jpg,RBC,1,322,75,425,1,74,103,38,373,0.059375,0.7770833333333333,0.115625,0.21458333333333332
BloodImage_00030.jpg,28.jpg,RBC,1,63,67,191,1,66,128,34,127,0.053125,0.26458333333333334,0.103125,0.26666666666666666
BloodImage_00030.jpg,28.jpg,RBC,297,1,428,81,1,131,80,362,41,0.565625,0.08541666666666667,0.2046875,0.16666666666666666
BloodImage_00030.jpg,28.jpg,RBC,500,238,597,339,1,97,101,548,288,0.85625,0.6,0.1515625,0.21041666666666667
BloodImage_00030.jpg,28.jpg,RBC,485,281,582,382,1,97,101,533,331,0.8328125,0.6895833333333333,0.1515625,0.21041666666666667
BloodImage_00030.jpg,28.jpg,RBC,473,338,570,439,1,97,101,521,388,0.8140625,0.8083333333333333,0.1515625,0.21041666666666667
BloodImage_00030.jpg,28.jpg,RBC,572,356,640,455,1,68,99,606,405,0.946875,0.84375,0.10625,0.20625
BloodImage_00030.jpg,28.jpg,RBC,525,7,640,148,1,115,141,582,77,0.909375,0.16041666666666668,0.1796875,0.29375
BloodImage_00030.jpg,28.jpg,RBC,445,35,558,159,1,113,124,501,97,0.7828125,0.20208333333333334,0.1765625,0.25833333333333336
BloodImage_00030.jpg,28.jpg,Platelets,347,91,389,137,0,42,46,368,114,0.575,0.2375,0.065625,0.09583333333333334
BloodImage_00030.jpg,28.jpg,Platelets,405,86,447,132,0,42,46,426,109,0.665625,0.22708333333333333,0.065625,0.09583333333333334
BloodImage_00030.jpg,28.jpg,Platelets,301,23,343,69,0,42,46,322,46,0.503125,0.09583333333333334,0.065625,0.09583333333333334
BloodImage_00030.jpg,28.jpg,RBC,286,123,396,229,1,110,106,341,176,0.5328125,0.36666666666666664,0.171875,0.22083333333333333
BloodImage_00031.jpg,29.jpg,WBC,127,143,270,273,2,143,130,198,208,0.309375,0.43333333333333335,0.2234375,0.2708333333333333
BloodImage_00031.jpg,29.jpg,WBC,287,364,437,480,2,150,116,362,422,0.565625,0.8791666666666667,0.234375,0.24166666666666667
BloodImage_00031.jpg,29.jpg,RBC,153,383,257,480,1,104,97,205,431,0.3203125,0.8979166666666667,0.1625,0.20208333333333334
BloodImage_00031.jpg,29.jpg,RBC,47,358,151,455,1,104,97,99,406,0.1546875,0.8458333333333333,0.1625,0.20208333333333334
BloodImage_00031.jpg,29.jpg,RBC,83,321,187,418,1,104,97,135,369,0.2109375,0.76875,0.1625,0.20208333333333334
BloodImage_00031.jpg,29.jpg,RBC,332,153,436,250,1,104,97,384,201,0.6,0.41875,0.1625,0.20208333333333334
BloodImage_00031.jpg,29.jpg,RBC,395,228,514,329,1,119,101,454,278,0.709375,0.5791666666666667,0.1859375,0.21041666666666667
BloodImage_00031.jpg,29.jpg,RBC,520,396,631,480,1,111,84,575,438,0.8984375,0.9125,0.1734375,0.175
BloodImage_00031.jpg,29.jpg,RBC,556,319,640,404,1,84,85,598,361,0.934375,0.7520833333333333,0.13125,0.17708333333333334
BloodImage_00031.jpg,29.jpg,RBC,522,254,630,342,1,108,88,576,298,0.9,0.6208333333333333,0.16875,0.18333333333333332
BloodImage_00031.jpg,29.jpg,RBC,512,190,620,278,1,108,88,566,234,0.884375,0.4875,0.16875,0.18333333333333332
BloodImage_00031.jpg,29.jpg,RBC,534,58,640,181,1,106,123,587,119,0.9171875,0.24791666666666667,0.165625,0.25625
BloodImage_00031.jpg,29.jpg,RBC,453,1,593,71,1,140,70,523,36,0.8171875,0.075,0.21875,0.14583333333333334
BloodImage_00031.jpg,29.jpg,Platelets,241,381,298,426,0,57,45,269,403,0.4203125,0.8395833333333333,0.0890625,0.09375
BloodImage_00031.jpg,29.jpg,Platelets,110,247,148,289,0,38,42,129,268,0.2015625,0.5583333333333333,0.059375,0.0875
BloodImage_00031.jpg,29.jpg,Platelets,343,108,381,150,0,38,42,362,129,0.565625,0.26875,0.059375,0.0875
BloodImage_00031.jpg,29.jpg,Platelets,409,88,447,130,0,38,42,428,109,0.66875,0.22708333333333333,0.059375,0.0875
BloodImage_00031.jpg,29.jpg,RBC,301,211,405,308,1,104,97,353,259,0.5515625,0.5395833333333333,0.1625,0.20208333333333334
BloodImage_00031.jpg,29.jpg,RBC,251,264,355,361,1,104,97,303,312,0.4734375,0.65,0.1625,0.20208333333333334
BloodImage_00031.jpg,29.jpg,RBC,27,1,141,98,1,114,97,84,49,0.13125,0.10208333333333333,0.178125,0.20208333333333334
BloodImage_00031.jpg,29.jpg,RBC,1,65,91,160,1,90,95,46,112,0.071875,0.23333333333333334,0.140625,0.19791666666666666
BloodImage_00031.jpg,29.jpg,RBC,57,62,148,157,1,91,95,102,109,0.159375,0.22708333333333333,0.1421875,0.19791666666666666
BloodImage_00031.jpg,29.jpg,RBC,1,246,94,370,1,93,124,47,308,0.0734375,0.6416666666666667,0.1453125,0.25833333333333336
BloodImage_00031.jpg,29.jpg,RBC,407,193,493,269,1,86,76,450,231,0.703125,0.48125,0.134375,0.15833333333333333
BloodImage_00032.jpg,30.jpg,WBC,158,77,285,198,2,127,121,221,137,0.3453125,0.28541666666666665,0.1984375,0.2520833333333333
BloodImage_00032.jpg,30.jpg,RBC,233,274,343,379,1,110,105,288,326,0.45,0.6791666666666667,0.171875,0.21875
BloodImage_00032.jpg,30.jpg,RBC,288,66,398,171,1,110,105,343,118,0.5359375,0.24583333333333332,0.171875,0.21875
BloodImage_00032.jpg,30.jpg,RBC,356,251,446,345,1,90,94,401,298,0.6265625,0.6208333333333333,0.140625,0.19583333333333333
BloodImage_00032.jpg,30.jpg,RBC,455,295,545,389,1,90,94,500,342,0.78125,0.7125,0.140625,0.19583333333333333
BloodImage_00032.jpg,30.jpg,RBC,419,312,509,406,1,90,94,464,359,0.725,0.7479166666666667,0.140625,0.19583333333333333
BloodImage_00032.jpg,30.jpg,RBC,332,365,457,474,1,125,109,394,419,0.615625,0.8729166666666667,0.1953125,0.22708333333333333
BloodImage_00032.jpg,30.jpg,RBC,199,221,297,309,1,98,88,248,265,0.3875,0.5520833333333334,0.153125,0.18333333333333332
BloodImage_00032.jpg,30.jpg,RBC,86,323,215,437,1,129,114,150,380,0.234375,0.7916666666666666,0.2015625,0.2375
BloodImage_00032.jpg,30.jpg,RBC,50,1,160,92,1,110,91,105,46,0.1640625,0.09583333333333334,0.171875,0.18958333333333333
BloodImage_00032.jpg,30.jpg,RBC,174,16,273,96,1,99,80,223,56,0.3484375,0.11666666666666667,0.1546875,0.16666666666666666
BloodImage_00032.jpg,30.jpg,RBC,406,1,517,89,1,111,88,461,45,0.7203125,0.09375,0.1734375,0.18333333333333332
BloodImage_00032.jpg,30.jpg,RBC,517,136,628,225,1,111,89,572,180,0.89375,0.375,0.1734375,0.18541666666666667
BloodImage_00032.jpg,30.jpg,RBC,521,197,632,286,1,111,89,576,241,0.9,0.5020833333333333,0.1734375,0.18541666666666667
BloodImage_00032.jpg,30.jpg,RBC,546,248,640,345,1,94,97,593,296,0.9265625,0.6166666666666667,0.146875,0.20208333333333334
BloodImage_00032.jpg,30.jpg,RBC,464,101,558,198,1,94,97,511,149,0.7984375,0.3104166666666667,0.146875,0.20208333333333334
BloodImage_00032.jpg,30.jpg,RBC,411,65,505,162,1,94,97,458,113,0.715625,0.23541666666666666,0.146875,0.20208333333333334
BloodImage_00032.jpg,30.jpg,RBC,421,134,515,231,1,94,97,468,182,0.73125,0.37916666666666665,0.146875,0.20208333333333334
BloodImage_00032.jpg,30.jpg,RBC,416,158,520,258,1,104,100,468,208,0.73125,0.43333333333333335,0.1625,0.20833333333333334
BloodImage_00032.jpg,30.jpg,RBC,391,160,495,260,1,104,100,443,210,0.6921875,0.4375,0.1625,0.20833333333333334
BloodImage_00032.jpg,30.jpg,RBC,350,182,454,282,1,104,100,402,232,0.628125,0.48333333333333334,0.1625,0.20833333333333334
BloodImage_00032.jpg,30.jpg,RBC,50,238,172,342,1,122,104,111,290,0.1734375,0.6041666666666666,0.190625,0.21666666666666667
BloodImage_00032.jpg,30.jpg,RBC,454,408,580,480,1,126,72,517,444,0.8078125,0.925,0.196875,0.15
BloodImage_00032.jpg,30.jpg,RBC,1,366,89,480,1,88,114,45,423,0.0703125,0.88125,0.1375,0.2375
BloodImage_00032.jpg,30.jpg,Platelets,102,105,140,151,0,38,46,121,128,0.1890625,0.26666666666666666,0.059375,0.09583333333333334
BloodImage_00033.jpg,31.jpg,WBC,129,109,280,251,2,151,142,204,180,0.31875,0.375,0.2359375,0.29583333333333334
BloodImage_00033.jpg,31.jpg,RBC,83,230,192,332,1,109,102,137,281,0.2140625,0.5854166666666667,0.1703125,0.2125
BloodImage_00033.jpg,31.jpg,RBC,303,238,394,359,1,91,121,348,298,0.54375,0.6208333333333333,0.1421875,0.2520833333333333
BloodImage_00033.jpg,31.jpg,RBC,276,245,346,365,1,70,120,311,305,0.4859375,0.6354166666666666,0.109375,0.25
BloodImage_00033.jpg,31.jpg,RBC,244,269,314,389,1,70,120,279,329,0.4359375,0.6854166666666667,0.109375,0.25
BloodImage_00033.jpg,31.jpg,RBC,219,287,289,407,1,70,120,254,347,0.396875,0.7229166666666667,0.109375,0.25
BloodImage_00033.jpg,31.jpg,RBC,190,291,260,411,1,70,120,225,351,0.3515625,0.73125,0.109375,0.25
BloodImage_00033.jpg,31.jpg,RBC,442,219,551,321,1,109,102,496,270,0.775,0.5625,0.1703125,0.2125
BloodImage_00033.jpg,31.jpg,RBC,391,207,500,309,1,109,102,445,258,0.6953125,0.5375,0.1703125,0.2125
BloodImage_00033.jpg,31.jpg,RBC,468,303,577,405,1,109,102,522,354,0.815625,0.7375,0.1703125,0.2125
BloodImage_00033.jpg,31.jpg,RBC,575,331,640,434,1,65,103,607,382,0.9484375,0.7958333333333333,0.1015625,0.21458333333333332
BloodImage_00033.jpg,31.jpg,RBC,568,89,640,185,1,72,96,604,137,0.94375,0.28541666666666665,0.1125,0.2
BloodImage_00033.jpg,31.jpg,RBC,532,36,640,134,1,108,98,586,85,0.915625,0.17708333333333334,0.16875,0.20416666666666666
BloodImage_00033.jpg,31.jpg,RBC,350,74,465,185,1,115,111,407,129,0.6359375,0.26875,0.1796875,0.23125
BloodImage_00033.jpg,31.jpg,RBC,297,1,414,91,1,117,90,355,46,0.5546875,0.09583333333333334,0.1828125,0.1875
BloodImage_00033.jpg,31.jpg,RBC,348,369,463,480,1,115,111,405,424,0.6328125,0.8833333333333333,0.1796875,0.23125
BloodImage_00033.jpg,31.jpg,RBC,177,389,286,480,1,109,91,231,434,0.3609375,0.9041666666666667,0.1703125,0.18958333333333333
BloodImage_00033.jpg,31.jpg,RBC,68,22,163,131,1,95,109,115,76,0.1796875,0.15833333333333333,0.1484375,0.22708333333333333
BloodImage_00033.jpg,31.jpg,RBC,198,1,291,89,1,93,88,244,45,0.38125,0.09375,0.1453125,0.18333333333333332
BloodImage_00034.jpg,32.jpg,WBC,350,181,543,359,2,193,178,446,270,0.696875,0.5625,0.3015625,0.37083333333333335
BloodImage_00034.jpg,32.jpg,WBC,310,351,458,480,2,148,129,384,415,0.6,0.8645833333333334,0.23125,0.26875
BloodImage_00034.jpg,32.jpg,Platelets,524,334,562,377,0,38,43,543,355,0.8484375,0.7395833333333334,0.059375,0.08958333333333333
BloodImage_00034.jpg,32.jpg,Platelets,52,85,90,128,0,38,43,71,106,0.1109375,0.22083333333333333,0.059375,0.08958333333333333
BloodImage_00034.jpg,32.jpg,RBC,127,130,259,270,1,132,140,193,200,0.3015625,0.4166666666666667,0.20625,0.2916666666666667
BloodImage_00034.jpg,32.jpg,RBC,97,298,205,415,1,108,117,151,356,0.2359375,0.7416666666666667,0.16875,0.24375
BloodImage_00034.jpg,32.jpg,RBC,1,336,107,453,1,106,117,54,394,0.084375,0.8208333333333333,0.165625,0.24375
BloodImage_00034.jpg,32.jpg,RBC,62,407,174,480,1,112,73,118,443,0.184375,0.9229166666666667,0.175,0.15208333333333332
BloodImage_00034.jpg,32.jpg,RBC,518,1,602,98,1,84,97,560,49,0.875,0.10208333333333333,0.13125,0.20208333333333334
BloodImage_00034.jpg,32.jpg,RBC,484,17,568,128,1,84,111,526,72,0.821875,0.15,0.13125,0.23125
BloodImage_00034.jpg,32.jpg,RBC,452,34,537,145,1,85,111,494,89,0.771875,0.18541666666666667,0.1328125,0.23125
BloodImage_00034.jpg,32.jpg,RBC,409,54,494,165,1,85,111,451,109,0.7046875,0.22708333333333333,0.1328125,0.23125
BloodImage_00034.jpg,32.jpg,RBC,358,84,443,195,1,85,111,400,139,0.625,0.28958333333333336,0.1328125,0.23125
BloodImage_00034.jpg,32.jpg,RBC,555,282,640,393,1,85,111,597,337,0.9328125,0.7020833333333333,0.1328125,0.23125
BloodImage_00034.jpg,32.jpg,RBC,571,352,640,464,1,69,112,605,408,0.9453125,0.85,0.1078125,0.23333333333333334
BloodImage_00034.jpg,32.jpg,RBC,102,23,175,128,1,73,105,138,75,0.215625,0.15625,0.1140625,0.21875
BloodImage_00034.jpg,32.jpg,RBC,143,22,226,126,1,83,104,184,74,0.2875,0.15416666666666667,0.1296875,0.21666666666666667
BloodImage_00034.jpg,32.jpg,RBC,278,16,372,121,1,94,105,325,68,0.5078125,0.14166666666666666,0.146875,0.21875
BloodImage_00034.jpg,32.jpg,RBC,207,283,320,401,1,113,118,263,342,0.4109375,0.7125,0.1765625,0.24583333333333332
BloodImage_00035.jpg,33.jpg,WBC,183,285,334,425,2,151,140,258,355,0.403125,0.7395833333333334,0.2359375,0.2916666666666667
BloodImage_00035.jpg,33.jpg,RBC,160,155,266,279,1,106,124,213,217,0.3328125,0.45208333333333334,0.165625,0.25833333333333336
BloodImage_00035.jpg,33.jpg,RBC,1,29,105,153,1,104,124,53,91,0.0828125,0.18958333333333333,0.1625,0.25833333333333336
BloodImage_00035.jpg,33.jpg,RBC,89,103,196,215,1,107,112,142,159,0.221875,0.33125,0.1671875,0.23333333333333334
BloodImage_00035.jpg,33.jpg,RBC,41,168,147,280,1,106,112,94,224,0.146875,0.4666666666666667,0.165625,0.23333333333333334
BloodImage_00035.jpg,33.jpg,RBC,82,234,189,346,1,107,112,135,290,0.2109375,0.6041666666666666,0.1671875,0.23333333333333334
BloodImage_00035.jpg,33.jpg,RBC,32,260,138,372,1,106,112,85,316,0.1328125,0.6583333333333333,0.165625,0.23333333333333334
BloodImage_00035.jpg,33.jpg,RBC,1,345,102,444,1,101,99,51,394,0.0796875,0.8208333333333333,0.1578125,0.20625
BloodImage_00035.jpg,33.jpg,RBC,292,401,395,480,1,103,79,343,440,0.5359375,0.9166666666666666,0.1609375,0.16458333333333333
BloodImage_00035.jpg,33.jpg,RBC,381,319,487,419,1,106,100,434,369,0.678125,0.76875,0.165625,0.20833333333333334
BloodImage_00035.jpg,33.jpg,RBC,456,312,534,419,1,78,107,495,365,0.7734375,0.7604166666666666,0.121875,0.22291666666666668
BloodImage_00035.jpg,33.jpg,RBC,478,277,594,406,1,116,129,536,341,0.8375,0.7104166666666667,0.18125,0.26875
BloodImage_00035.jpg,33.jpg,RBC,567,243,640,353,1,73,110,603,298,0.9421875,0.6208333333333333,0.1140625,0.22916666666666666
BloodImage_00035.jpg,33.jpg,RBC,559,389,640,480,1,81,91,599,434,0.9359375,0.9041666666666667,0.1265625,0.18958333333333333
BloodImage_00035.jpg,33.jpg,RBC,504,97,607,185,1,103,88,555,141,0.8671875,0.29375,0.1609375,0.18333333333333332
BloodImage_00035.jpg,33.jpg,RBC,374,83,533,207,1,159,124,453,145,0.7078125,0.3020833333333333,0.2484375,0.25833333333333336
BloodImage_00035.jpg,33.jpg,RBC,305,1,408,88,1,103,87,356,44,0.55625,0.09166666666666666,0.1609375,0.18125
BloodImage_00035.jpg,33.jpg,RBC,243,146,346,234,1,103,88,294,190,0.459375,0.3958333333333333,0.1609375,0.18333333333333332
BloodImage_00035.jpg,33.jpg,RBC,316,236,419,324,1,103,88,367,280,0.5734375,0.5833333333333334,0.1609375,0.18333333333333332
BloodImage_00035.jpg,33.jpg,Platelets,146,337,182,382,0,36,45,164,359,0.25625,0.7479166666666667,0.05625,0.09375
BloodImage_00035.jpg,33.jpg,Platelets,108,352,144,397,0,36,45,126,374,0.196875,0.7791666666666667,0.05625,0.09375
BloodImage_00035.jpg,33.jpg,Platelets,171,413,207,458,0,36,45,189,435,0.2953125,0.90625,0.05625,0.09375
BloodImage_00035.jpg,33.jpg,RBC,83,1,201,77,1,118,76,142,39,0.221875,0.08125,0.184375,0.15833333333333333
BloodImage_00036.jpg,34.jpg,WBC,107,242,287,423,2,180,181,197,332,0.3078125,0.6916666666666667,0.28125,0.3770833333333333
BloodImage_00036.jpg,34.jpg,RBC,207,106,319,209,1,112,103,263,157,0.4109375,0.32708333333333334,0.175,0.21458333333333332
BloodImage_00036.jpg,34.jpg,RBC,166,130,278,233,1,112,103,222,181,0.346875,0.3770833333333333,0.175,0.21458333333333332
BloodImage_00036.jpg,34.jpg,RBC,405,171,499,274,1,94,103,452,222,0.70625,0.4625,0.146875,0.21458333333333332
BloodImage_00036.jpg,34.jpg,RBC,487,106,599,209,1,112,103,543,157,0.8484375,0.32708333333333334,0.175,0.21458333333333332
BloodImage_00036.jpg,34.jpg,RBC,545,315,640,428,1,95,113,592,371,0.925,0.7729166666666667,0.1484375,0.23541666666666666
BloodImage_00036.jpg,34.jpg,RBC,260,370,355,480,1,95,110,307,425,0.4796875,0.8854166666666666,0.1484375,0.22916666666666666
BloodImage_00036.jpg,34.jpg,RBC,1,266,88,360,1,87,94,44,313,0.06875,0.6520833333333333,0.1359375,0.19583333333333333
BloodImage_00036.jpg,34.jpg,RBC,1,138,99,242,1,98,104,50,190,0.078125,0.3958333333333333,0.153125,0.21666666666666667
BloodImage_00036.jpg,34.jpg,RBC,60,87,160,191,1,100,104,110,139,0.171875,0.28958333333333336,0.15625,0.21666666666666667
BloodImage_00036.jpg,34.jpg,RBC,301,21,429,135,1,128,114,365,78,0.5703125,0.1625,0.2,0.2375
BloodImage_00036.jpg,34.jpg,RBC,397,60,494,168,1,97,108,445,114,0.6953125,0.2375,0.1515625,0.225
BloodImage_00036.jpg,34.jpg,RBC,543,242,639,350,1,96,108,591,296,0.9234375,0.6166666666666667,0.15,0.225
BloodImage_00036.jpg,34.jpg,RBC,391,168,453,270,1,62,102,422,219,0.659375,0.45625,0.096875,0.2125
BloodImage_00036.jpg,34.jpg,RBC,421,1,518,80,1,97,79,469,40,0.7328125,0.08333333333333333,0.1515625,0.16458333333333333
BloodImage_00036.jpg,34.jpg,RBC,480,1,577,80,1,97,79,528,40,0.825,0.08333333333333333,0.1515625,0.16458333333333333
BloodImage_00036.jpg,34.jpg,Platelets,162,91,198,126,0,36,35,180,108,0.28125,0.225,0.05625,0.07291666666666667
BloodImage_00036.jpg,34.jpg,RBC,468,264,562,367,1,94,103,515,315,0.8046875,0.65625,0.146875,0.21458333333333332
BloodImage_00036.jpg,34.jpg,RBC,107,1,210,86,1,103,85,158,43,0.246875,0.08958333333333333,0.1609375,0.17708333333333334
BloodImage_00036.jpg,34.jpg,RBC,70,389,205,477,1,135,88,137,433,0.2140625,0.9020833333333333,0.2109375,0.18333333333333332
BloodImage_00037.jpg,35.jpg,WBC,421,302,541,420,2,120,118,481,361,0.7515625,0.7520833333333333,0.1875,0.24583333333333332
BloodImage_00037.jpg,35.jpg,RBC,187,107,291,225,1,104,118,239,166,0.3734375,0.3458333333333333,0.1625,0.24583333333333332
BloodImage_00037.jpg,35.jpg,RBC,272,89,375,180,1,103,91,323,134,0.5046875,0.2791666666666667,0.1609375,0.18958333333333333
BloodImage_00037.jpg,35.jpg,RBC,251,175,354,266,1,103,91,302,220,0.471875,0.4583333333333333,0.1609375,0.18958333333333333
BloodImage_00037.jpg,35.jpg,RBC,268,199,371,290,1,103,91,319,244,0.4984375,0.5083333333333333,0.1609375,0.18958333333333333
BloodImage_00037.jpg,35.jpg,RBC,529,130,636,252,1,107,122,582,191,0.909375,0.39791666666666664,0.1671875,0.25416666666666665
BloodImage_00037.jpg,35.jpg,RBC,553,191,640,296,1,87,105,596,243,0.93125,0.50625,0.1359375,0.21875
BloodImage_00037.jpg,35.jpg,RBC,479,215,566,320,1,87,105,522,267,0.815625,0.55625,0.1359375,0.21875
BloodImage_00037.jpg,35.jpg,RBC,448,186,535,291,1,87,105,491,238,0.7671875,0.49583333333333335,0.1359375,0.21875
BloodImage_00037.jpg,35.jpg,RBC,410,177,497,282,1,87,105,453,229,0.7078125,0.47708333333333336,0.1359375,0.21875
BloodImage_00037.jpg,35.jpg,RBC,362,156,449,261,1,87,105,405,208,0.6328125,0.43333333333333335,0.1359375,0.21875
BloodImage_00037.jpg,35.jpg,RBC,520,33,607,138,1,87,105,563,85,0.8796875,0.17708333333333334,0.1359375,0.21875
BloodImage_00037.jpg,35.jpg,RBC,479,26,566,131,1,87,105,522,78,0.815625,0.1625,0.1359375,0.21875
BloodImage_00037.jpg,35.jpg,RBC,389,15,476,120,1,87,105,432,67,0.675,0.13958333333333334,0.1359375,0.21875
BloodImage_00037.jpg,35.jpg,RBC,96,382,183,471,1,87,89,139,426,0.2171875,0.8875,0.1359375,0.18541666666666667
BloodImage_00037.jpg,35.jpg,RBC,14,320,101,409,1,87,89,57,364,0.0890625,0.7583333333333333,0.1359375,0.18541666666666667
BloodImage_00037.jpg,35.jpg,RBC,17,76,104,165,1,87,89,60,120,0.09375,0.25,0.1359375,0.18541666666666667
BloodImage_00037.jpg,35.jpg,RBC,14,136,115,238,1,101,102,64,187,0.1,0.38958333333333334,0.1578125,0.2125
BloodImage_00037.jpg,35.jpg,RBC,37,171,138,273,1,101,102,87,222,0.1359375,0.4625,0.1578125,0.2125
BloodImage_00037.jpg,35.jpg,RBC,48,5,147,81,1,99,76,97,43,0.1515625,0.08958333333333333,0.1546875,0.15833333333333333
BloodImage_00037.jpg,35.jpg,RBC,113,13,212,89,1,99,76,162,51,0.253125,0.10625,0.1546875,0.15833333333333333
BloodImage_00037.jpg,35.jpg,RBC,126,31,225,107,1,99,76,175,69,0.2734375,0.14375,0.1546875,0.15833333333333333
BloodImage_00037.jpg,35.jpg,RBC,543,335,640,440,1,97,105,591,387,0.9234375,0.80625,0.1515625,0.21875
BloodImage_00037.jpg,35.jpg,RBC,331,436,424,480,1,93,44,377,458,0.5890625,0.9541666666666667,0.1453125,0.09166666666666666
BloodImage_00037.jpg,35.jpg,RBC,179,305,292,411,1,113,106,235,358,0.3671875,0.7458333333333333,0.1765625,0.22083333333333333
BloodImage_00037.jpg,35.jpg,RBC,145,241,258,347,1,113,106,201,294,0.3140625,0.6125,0.1765625,0.22083333333333333
BloodImage_00037.jpg,35.jpg,RBC,95,224,208,330,1,113,106,151,277,0.2359375,0.5770833333333333,0.1765625,0.22083333333333333
BloodImage_00037.jpg,35.jpg,Platelets,132,111,174,157,0,42,46,153,134,0.2390625,0.2791666666666667,0.065625,0.09583333333333334
BloodImage_00037.jpg,35.jpg,Platelets,364,63,397,101,0,33,38,380,82,0.59375,0.17083333333333334,0.0515625,0.07916666666666666
BloodImage_00037.jpg,35.jpg,RBC,1,248,102,347,1,101,99,51,297,0.0796875,0.61875,0.1578125,0.20625
BloodImage_00038.jpg,36.jpg,WBC,415,304,533,427,2,118,123,474,365,0.740625,0.7604166666666666,0.184375,0.25625
BloodImage_00038.jpg,36.jpg,RBC,155,389,255,455,1,100,66,205,422,0.3203125,0.8791666666666667,0.15625,0.1375
BloodImage_00038.jpg,36.jpg,RBC,96,399,194,476,1,98,77,145,437,0.2265625,0.9104166666666667,0.153125,0.16041666666666668
BloodImage_00038.jpg,36.jpg,RBC,11,261,91,360,1,80,99,51,310,0.0796875,0.6458333333333334,0.125,0.20625
BloodImage_00038.jpg,36.jpg,RBC,19,312,99,411,1,80,99,59,361,0.0921875,0.7520833333333333,0.125,0.20625
BloodImage_00038.jpg,36.jpg,RBC,14,77,94,176,1,80,99,54,126,0.084375,0.2625,0.125,0.20625
BloodImage_00038.jpg,36.jpg,RBC,22,142,122,243,1,100,101,72,192,0.1125,0.4,0.15625,0.21041666666666667
BloodImage_00038.jpg,36.jpg,RBC,61,194,140,295,1,79,101,100,244,0.15625,0.5083333333333333,0.1234375,0.21041666666666667
BloodImage_00038.jpg,36.jpg,RBC,93,224,172,325,1,79,101,132,274,0.20625,0.5708333333333333,0.1234375,0.21041666666666667
BloodImage_00038.jpg,36.jpg,RBC,117,233,196,334,1,79,101,156,283,0.24375,0.5895833333333333,0.1234375,0.21041666666666667
BloodImage_00038.jpg,36.jpg,RBC,171,236,265,340,1,94,104,218,288,0.340625,0.6,0.146875,0.21666666666666667
BloodImage_00038.jpg,36.jpg,RBC,265,186,359,290,1,94,104,312,238,0.4875,0.49583333333333335,0.146875,0.21666666666666667
BloodImage_00038.jpg,36.jpg,RBC,186,112,294,236,1,108,124,240,174,0.375,0.3625,0.16875,0.25833333333333336
BloodImage_00038.jpg,36.jpg,Platelets,140,117,174,156,0,34,39,157,136,0.2453125,0.2833333333333333,0.053125,0.08125
BloodImage_00038.jpg,36.jpg,Platelets,373,62,407,101,0,34,39,390,81,0.609375,0.16875,0.053125,0.08125
BloodImage_00038.jpg,36.jpg,RBC,281,94,373,176,1,92,82,327,135,0.5109375,0.28125,0.14375,0.17083333333333334
BloodImage_00038.jpg,36.jpg,RBC,515,41,607,123,1,92,82,561,82,0.8765625,0.17083333333333334,0.14375,0.17083333333333334
BloodImage_00038.jpg,36.jpg,RBC,472,15,565,138,1,93,123,518,76,0.809375,0.15833333333333333,0.1453125,0.25625
BloodImage_00038.jpg,36.jpg,RBC,544,128,638,251,1,94,123,591,189,0.9234375,0.39375,0.146875,0.25625
BloodImage_00038.jpg,36.jpg,RBC,562,206,640,299,1,78,93,601,252,0.9390625,0.525,0.121875,0.19375
BloodImage_00038.jpg,36.jpg,RBC,475,229,568,323,1,93,94,521,276,0.8140625,0.575,0.1453125,0.19583333333333333
BloodImage_00038.jpg,36.jpg,RBC,439,191,532,285,1,93,94,485,238,0.7578125,0.49583333333333335,0.1453125,0.19583333333333333
BloodImage_00038.jpg,36.jpg,RBC,392,178,485,272,1,93,94,438,225,0.684375,0.46875,0.1453125,0.19583333333333333
BloodImage_00038.jpg,36.jpg,RBC,547,332,640,426,1,93,94,593,379,0.9265625,0.7895833333333333,0.1453125,0.19583333333333333
BloodImage_00038.jpg,36.jpg,RBC,547,386,640,480,1,93,94,593,433,0.9265625,0.9020833333333333,0.1453125,0.19583333333333333
BloodImage_00038.jpg,36.jpg,RBC,488,386,581,480,1,93,94,534,433,0.834375,0.9020833333333333,0.1453125,0.19583333333333333
BloodImage_00038.jpg,36.jpg,RBC,137,15,230,109,1,93,94,183,62,0.2859375,0.12916666666666668,0.1453125,0.19583333333333333
BloodImage_00038.jpg,36.jpg,RBC,385,30,478,124,1,93,94,431,77,0.6734375,0.16041666666666668,0.1453125,0.19583333333333333
BloodImage_00039.jpg,37.jpg,WBC,107,212,270,347,2,163,135,188,279,0.29375,0.58125,0.2546875,0.28125
BloodImage_00039.jpg,37.jpg,RBC,245,86,370,198,1,125,112,307,142,0.4796875,0.29583333333333334,0.1953125,0.23333333333333334
BloodImage_00039.jpg,37.jpg,RBC,47,165,140,259,1,93,94,93,212,0.1453125,0.44166666666666665,0.1453125,0.19583333333333333
BloodImage_00039.jpg,37.jpg,RBC,12,76,145,179,1,133,103,78,127,0.121875,0.26458333333333334,0.2078125,0.21458333333333332
BloodImage_00039.jpg,37.jpg,RBC,195,346,296,447,1,101,101,245,396,0.3828125,0.825,0.1578125,0.21041666666666667
BloodImage_00039.jpg,37.jpg,RBC,120,358,221,459,1,101,101,170,408,0.265625,0.85,0.1578125,0.21041666666666667
BloodImage_00039.jpg,37.jpg,RBC,83,356,184,457,1,101,101,133,406,0.2078125,0.8458333333333333,0.1578125,0.21041666666666667
BloodImage_00039.jpg,37.jpg,RBC,15,356,116,457,1,101,101,65,406,0.1015625,0.8458333333333333,0.1578125,0.21041666666666667
BloodImage_00039.jpg,37.jpg,RBC,310,309,411,410,1,101,101,360,359,0.5625,0.7479166666666667,0.1578125,0.21041666666666667
BloodImage_00039.jpg,37.jpg,RBC,417,304,518,405,1,101,101,467,354,0.7296875,0.7375,0.1578125,0.21041666666666667
BloodImage_00039.jpg,37.jpg,RBC,485,197,586,298,1,101,101,535,247,0.8359375,0.5145833333333333,0.1578125,0.21041666666666667
BloodImage_00039.jpg,37.jpg,RBC,474,2,589,111,1,115,109,531,56,0.8296875,0.11666666666666667,0.1796875,0.22708333333333333
BloodImage_00039.jpg,37.jpg,RBC,358,1,474,95,1,116,94,416,48,0.65,0.1,0.18125,0.19583333333333333
BloodImage_00039.jpg,37.jpg,RBC,111,1,227,95,1,116,94,169,48,0.2640625,0.1,0.18125,0.19583333333333333
BloodImage_00039.jpg,37.jpg,RBC,131,77,247,172,1,116,95,189,124,0.2953125,0.25833333333333336,0.18125,0.19791666666666666
BloodImage_00039.jpg,37.jpg,Platelets,1,19,45,61,0,44,42,23,40,0.0359375,0.08333333333333333,0.06875,0.0875
BloodImage_00039.jpg,37.jpg,Platelets,548,293,583,324,0,35,31,565,308,0.8828125,0.6416666666666667,0.0546875,0.06458333333333334
BloodImage_00039.jpg,37.jpg,RBC,377,171,502,283,1,125,112,439,227,0.6859375,0.47291666666666665,0.1953125,0.23333333333333334
BloodImage_00039.jpg,37.jpg,RBC,487,391,574,480,1,87,89,530,435,0.828125,0.90625,0.1359375,0.18541666666666667
BloodImage_00040.jpg,38.jpg,WBC,242,117,457,332,2,215,215,349,224,0.5453125,0.4666666666666667,0.3359375,0.4479166666666667
BloodImage_00040.jpg,38.jpg,RBC,140,308,249,415,1,109,107,194,361,0.303125,0.7520833333333333,0.1703125,0.22291666666666668
BloodImage_00040.jpg,38.jpg,RBC,96,362,205,469,1,109,107,150,415,0.234375,0.8645833333333334,0.1703125,0.22291666666666668
BloodImage_00040.jpg,38.jpg,RBC,1,323,89,430,1,88,107,45,376,0.0703125,0.7833333333333333,0.1375,0.22291666666666668
BloodImage_00040.jpg,38.jpg,RBC,79,212,212,317,1,133,105,145,264,0.2265625,0.55,0.2078125,0.21875
BloodImage_00040.jpg,38.jpg,RBC,105,108,238,213,1,133,105,171,160,0.2671875,0.3333333333333333,0.2078125,0.21875
BloodImage_00040.jpg,38.jpg,RBC,463,104,596,209,1,133,105,529,156,0.8265625,0.325,0.2078125,0.21875
BloodImage_00040.jpg,38.jpg,RBC,526,95,640,189,1,114,94,583,142,0.9109375,0.29583333333333334,0.178125,0.19583333333333333
BloodImage_00040.jpg,38.jpg,RBC,529,204,640,318,1,111,114,584,261,0.9125,0.54375,0.1734375,0.2375
BloodImage_00040.jpg,38.jpg,RBC,464,312,575,426,1,111,114,519,369,0.8109375,0.76875,0.1734375,0.2375
BloodImage_00040.jpg,38.jpg,RBC,332,314,457,428,1,125,114,394,371,0.615625,0.7729166666666667,0.1953125,0.2375
BloodImage_00040.jpg,38.jpg,RBC,255,322,380,436,1,125,114,317,379,0.4953125,0.7895833333333333,0.1953125,0.2375
BloodImage_00040.jpg,38.jpg,RBC,264,392,387,480,1,123,88,325,436,0.5078125,0.9083333333333333,0.1921875,0.18333333333333332
BloodImage_00040.jpg,38.jpg,RBC,12,106,123,207,1,111,101,67,156,0.1046875,0.325,0.1734375,0.21041666666666667
BloodImage_00040.jpg,38.jpg,RBC,538,1,639,85,1,101,84,588,43,0.91875,0.08958333333333333,0.1578125,0.175
BloodImage_00040.jpg,38.jpg,Platelets,428,11,473,50,0,45,39,450,30,0.703125,0.0625,0.0703125,0.08125
BloodImage_00040.jpg,38.jpg,Platelets,489,46,534,85,0,45,39,511,65,0.7984375,0.13541666666666666,0.0703125,0.08125
BloodImage_00040.jpg,38.jpg,Platelets,48,206,93,245,0,45,39,70,225,0.109375,0.46875,0.0703125,0.08125
BloodImage_00041.jpg,39.jpg,WBC,261,219,424,381,2,163,162,342,300,0.534375,0.625,0.2546875,0.3375
BloodImage_00041.jpg,39.jpg,RBC,228,13,374,121,1,146,108,301,67,0.4703125,0.13958333333333334,0.228125,0.225
BloodImage_00041.jpg,39.jpg,RBC,321,117,437,236,1,116,119,379,176,0.5921875,0.36666666666666664,0.18125,0.24791666666666667
BloodImage_00041.jpg,39.jpg,RBC,478,83,594,202,1,116,119,536,142,0.8375,0.29583333333333334,0.18125,0.24791666666666667
BloodImage_00041.jpg,39.jpg,RBC,435,147,551,266,1,116,119,493,206,0.7703125,0.42916666666666664,0.18125,0.24791666666666667
BloodImage_00041.jpg,39.jpg,RBC,414,220,530,339,1,116,119,472,279,0.7375,0.58125,0.18125,0.24791666666666667
BloodImage_00041.jpg,39.jpg,RBC,480,250,579,352,1,99,102,529,301,0.8265625,0.6270833333333333,0.1546875,0.2125
BloodImage_00041.jpg,39.jpg,RBC,478,304,577,406,1,99,102,527,355,0.8234375,0.7395833333333334,0.1546875,0.2125
BloodImage_00041.jpg,39.jpg,RBC,455,353,554,455,1,99,102,504,404,0.7875,0.8416666666666667,0.1546875,0.2125
BloodImage_00041.jpg,39.jpg,RBC,531,310,630,412,1,99,102,580,361,0.90625,0.7520833333333333,0.1546875,0.2125
BloodImage_00041.jpg,39.jpg,RBC,1,12,80,128,1,79,116,40,70,0.0625,0.14583333333333334,0.1234375,0.24166666666666667
BloodImage_00041.jpg,39.jpg,RBC,76,1,198,109,1,122,108,137,55,0.2140625,0.11458333333333333,0.190625,0.225
BloodImage_00041.jpg,39.jpg,RBC,427,1,562,114,1,135,113,494,57,0.771875,0.11875,0.2109375,0.23541666666666666
BloodImage_00041.jpg,39.jpg,Platelets,396,2,440,60,0,44,58,418,31,0.653125,0.06458333333333334,0.06875,0.12083333333333333
BloodImage_00041.jpg,39.jpg,Platelets,210,419,252,453,0,42,34,231,436,0.3609375,0.9083333333333333,0.065625,0.07083333333333333
BloodImage_00041.jpg,39.jpg,RBC,196,111,294,220,1,98,109,245,165,0.3828125,0.34375,0.153125,0.22708333333333333
BloodImage_00041.jpg,39.jpg,RBC,25,151,123,260,1,98,109,74,205,0.115625,0.4270833333333333,0.153125,0.22708333333333333
BloodImage_00041.jpg,39.jpg,RBC,43,410,132,480,1,89,70,87,445,0.1359375,0.9270833333333334,0.1390625,0.14583333333333334
BloodImage_00041.jpg,39.jpg,RBC,124,410,213,480,1,89,70,168,445,0.2625,0.9270833333333334,0.1390625,0.14583333333333334
BloodImage_00041.jpg,39.jpg,RBC,1,373,98,460,1,97,87,49,416,0.0765625,0.8666666666666667,0.1515625,0.18125
BloodImage_00042.jpg,40.jpg,WBC,116,192,278,319,2,162,127,197,255,0.3078125,0.53125,0.253125,0.26458333333333334
BloodImage_00042.jpg,40.jpg,RBC,65,42,151,172,1,86,130,108,107,0.16875,0.22291666666666668,0.134375,0.2708333333333333
BloodImage_00042.jpg,40.jpg,RBC,236,281,330,377,1,94,96,283,329,0.4421875,0.6854166666666667,0.146875,0.2
BloodImage_00042.jpg,40.jpg,RBC,355,316,449,412,1,94,96,402,364,0.628125,0.7583333333333333,0.146875,0.2
BloodImage_00042.jpg,40.jpg,RBC,545,187,639,313,1,94,126,592,250,0.925,0.5208333333333334,0.146875,0.2625
BloodImage_00042.jpg,40.jpg,RBC,545,81,640,207,1,95,126,592,144,0.925,0.3,0.1484375,0.2625
BloodImage_00042.jpg,40.jpg,RBC,562,1,640,101,1,78,100,601,51,0.9390625,0.10625,0.121875,0.20833333333333334
BloodImage_00042.jpg,40.jpg,RBC,151,1,260,84,1,109,83,205,42,0.3203125,0.0875,0.1703125,0.17291666666666666
BloodImage_00042.jpg,40.jpg,RBC,248,1,396,77,1,148,76,322,39,0.503125,0.08125,0.23125,0.15833333333333333
BloodImage_00042.jpg,40.jpg,RBC,303,149,412,233,1,109,84,357,191,0.5578125,0.39791666666666664,0.1703125,0.175
BloodImage_00042.jpg,40.jpg,RBC,95,377,260,476,1,165,99,177,426,0.2765625,0.8875,0.2578125,0.20625
BloodImage_00042.jpg,40.jpg,Platelets,401,179,451,215,0,50,36,426,197,0.665625,0.41041666666666665,0.078125,0.075
BloodImage_00042.jpg,40.jpg,Platelets,1,282,30,321,0,29,39,15,301,0.0234375,0.6270833333333333,0.0453125,0.08125
BloodImage_00042.jpg,40.jpg,RBC,442,222,553,350,1,111,128,497,286,0.7765625,0.5958333333333333,0.1734375,0.26666666666666666
BloodImage_00042.jpg,40.jpg,RBC,411,346,505,442,1,94,96,458,394,0.715625,0.8208333333333333,0.146875,0.2
BloodImage_00042.jpg,40.jpg,RBC,463,384,563,480,1,100,96,513,432,0.8015625,0.9,0.15625,0.2
BloodImage_00043.jpg,41.jpg,WBC,76,106,217,228,2,141,122,146,167,0.228125,0.34791666666666665,0.2203125,0.25416666666666665
BloodImage_00043.jpg,41.jpg,WBC,498,304,639,480,2,141,176,568,392,0.8875,0.8166666666666667,0.2203125,0.36666666666666664
BloodImage_00043.jpg,41.jpg,Platelets,177,76,211,115,0,34,39,194,95,0.303125,0.19791666666666666,0.053125,0.08125
BloodImage_00043.jpg,41.jpg,Platelets,61,441,95,480,0,34,39,78,460,0.121875,0.9583333333333334,0.053125,0.08125
BloodImage_00043.jpg,41.jpg,RBC,17,330,144,428,1,127,98,80,379,0.125,0.7895833333333333,0.1984375,0.20416666666666666
BloodImage_00043.jpg,41.jpg,RBC,107,345,234,443,1,127,98,170,394,0.265625,0.8208333333333333,0.1984375,0.20416666666666666
BloodImage_00043.jpg,41.jpg,RBC,86,223,213,321,1,127,98,149,272,0.2328125,0.5666666666666667,0.1984375,0.20416666666666666
BloodImage_00043.jpg,41.jpg,RBC,31,208,158,306,1,127,98,94,257,0.146875,0.5354166666666667,0.1984375,0.20416666666666666
BloodImage_00043.jpg,41.jpg,RBC,367,286,494,384,1,127,98,430,335,0.671875,0.6979166666666666,0.1984375,0.20416666666666666
BloodImage_00043.jpg,41.jpg,RBC,346,175,473,273,1,127,98,409,224,0.6390625,0.4666666666666667,0.1984375,0.20416666666666666
BloodImage_00043.jpg,41.jpg,RBC,296,46,423,144,1,127,98,359,95,0.5609375,0.19791666666666666,0.1984375,0.20416666666666666
BloodImage_00043.jpg,41.jpg,RBC,417,84,511,188,1,94,104,464,136,0.725,0.2833333333333333,0.146875,0.21666666666666667
BloodImage_00043.jpg,41.jpg,RBC,4,1,98,104,1,94,103,51,52,0.0796875,0.10833333333333334,0.146875,0.21458333333333332
BloodImage_00043.jpg,41.jpg,RBC,1,97,77,200,1,76,103,39,148,0.0609375,0.30833333333333335,0.11875,0.21458333333333332
BloodImage_00043.jpg,41.jpg,RBC,564,49,640,167,1,76,118,602,108,0.940625,0.225,0.11875,0.24583333333333332
BloodImage_00043.jpg,41.jpg,RBC,507,126,623,245,1,116,119,565,185,0.8828125,0.3854166666666667,0.18125,0.24791666666666667
BloodImage_00044.jpg,42.jpg,WBC,196,257,345,411,2,149,154,270,334,0.421875,0.6958333333333333,0.2328125,0.32083333333333336
BloodImage_00044.jpg,42.jpg,WBC,1,40,121,154,2,120,114,61,97,0.0953125,0.20208333333333334,0.1875,0.2375
BloodImage_00044.jpg,42.jpg,RBC,68,371,209,473,1,141,102,138,422,0.215625,0.8791666666666667,0.2203125,0.2125
BloodImage_00044.jpg,42.jpg,RBC,69,288,154,383,1,85,95,111,335,0.1734375,0.6979166666666666,0.1328125,0.19791666666666666
BloodImage_00044.jpg,42.jpg,RBC,409,54,517,161,1,108,107,463,107,0.7234375,0.22291666666666668,0.16875,0.22291666666666668
BloodImage_00044.jpg,42.jpg,RBC,49,142,157,249,1,108,107,103,195,0.1609375,0.40625,0.16875,0.22291666666666668
BloodImage_00044.jpg,42.jpg,RBC,207,59,315,166,1,108,107,261,112,0.4078125,0.23333333333333334,0.16875,0.22291666666666668
BloodImage_00044.jpg,42.jpg,RBC,170,145,278,252,1,108,107,224,198,0.35,0.4125,0.16875,0.22291666666666668
BloodImage_00044.jpg,42.jpg,RBC,301,23,409,130,1,108,107,355,76,0.5546875,0.15833333333333333,0.16875,0.22291666666666668
BloodImage_00044.jpg,42.jpg,RBC,503,168,611,275,1,108,107,557,221,0.8703125,0.46041666666666664,0.16875,0.22291666666666668
BloodImage_00044.jpg,42.jpg,RBC,520,94,628,201,1,108,107,574,147,0.896875,0.30625,0.16875,0.22291666666666668
BloodImage_00044.jpg,42.jpg,RBC,505,30,613,137,1,108,107,559,83,0.8734375,0.17291666666666666,0.16875,0.22291666666666668
BloodImage_00044.jpg,42.jpg,RBC,516,415,622,480,1,106,65,569,447,0.8890625,0.93125,0.165625,0.13541666666666666
BloodImage_00044.jpg,42.jpg,RBC,1,323,79,435,1,78,112,40,379,0.0625,0.7895833333333333,0.121875,0.23333333333333334
BloodImage_00044.jpg,42.jpg,Platelets,520,377,555,413,0,35,36,537,395,0.8390625,0.8229166666666666,0.0546875,0.075
BloodImage_00044.jpg,42.jpg,Platelets,561,366,596,402,0,35,36,578,384,0.903125,0.8,0.0546875,0.075
BloodImage_00044.jpg,42.jpg,Platelets,353,434,388,470,0,35,36,370,452,0.578125,0.9416666666666667,0.0546875,0.075
BloodImage_00044.jpg,42.jpg,Platelets,114,126,150,157,0,36,31,132,141,0.20625,0.29375,0.05625,0.06458333333333334
BloodImage_00044.jpg,42.jpg,RBC,387,319,482,412,1,95,93,434,365,0.678125,0.7604166666666666,0.1484375,0.19375
BloodImage_00044.jpg,42.jpg,Platelets,502,310,537,346,0,35,36,519,328,0.8109375,0.6833333333333333,0.0546875,0.075
BloodImage_00045.jpg,43.jpg,RBC,326,235,422,338,1,96,103,374,286,0.584375,0.5958333333333333,0.15,0.21458333333333332
BloodImage_00045.jpg,43.jpg,RBC,173,272,269,375,1,96,103,221,323,0.3453125,0.6729166666666667,0.15,0.21458333333333332
BloodImage_00045.jpg,43.jpg,RBC,223,273,319,376,1,96,103,271,324,0.4234375,0.675,0.15,0.21458333333333332
BloodImage_00045.jpg,43.jpg,RBC,240,361,344,460,1,104,99,292,410,0.45625,0.8541666666666666,0.1625,0.20625
BloodImage_00045.jpg,43.jpg,RBC,81,336,185,435,1,104,99,133,385,0.2078125,0.8020833333333334,0.1625,0.20625
BloodImage_00045.jpg,43.jpg,RBC,1,344,103,443,1,102,99,52,393,0.08125,0.81875,0.159375,0.20625
BloodImage_00045.jpg,43.jpg,RBC,349,398,445,480,1,96,82,397,439,0.6203125,0.9145833333333333,0.15,0.17083333333333334
BloodImage_00045.jpg,43.jpg,RBC,386,386,482,468,1,96,82,434,427,0.678125,0.8895833333333333,0.15,0.17083333333333334
BloodImage_00045.jpg,43.jpg,RBC,410,360,506,442,1,96,82,458,401,0.715625,0.8354166666666667,0.15,0.17083333333333334
BloodImage_00045.jpg,43.jpg,RBC,451,339,547,421,1,96,82,499,380,0.7796875,0.7916666666666666,0.15,0.17083333333333334
BloodImage_00045.jpg,43.jpg,RBC,475,319,571,401,1,96,82,523,360,0.8171875,0.75,0.15,0.17083333333333334
BloodImage_00045.jpg,43.jpg,RBC,495,304,591,386,1,96,82,543,345,0.8484375,0.71875,0.15,0.17083333333333334
BloodImage_00045.jpg,43.jpg,RBC,437,201,533,283,1,96,82,485,242,0.7578125,0.5041666666666667,0.15,0.17083333333333334
BloodImage_00045.jpg,43.jpg,RBC,470,209,566,291,1,96,82,518,250,0.809375,0.5208333333333334,0.15,0.17083333333333334
BloodImage_00045.jpg,43.jpg,RBC,506,222,602,304,1,96,82,554,263,0.865625,0.5479166666666667,0.15,0.17083333333333334
BloodImage_00045.jpg,43.jpg,RBC,390,90,489,194,1,99,104,439,142,0.6859375,0.29583333333333334,0.1546875,0.21666666666666667
BloodImage_00045.jpg,43.jpg,RBC,1,109,99,213,1,98,104,50,161,0.078125,0.33541666666666664,0.153125,0.21666666666666667
BloodImage_00045.jpg,43.jpg,RBC,80,69,180,173,1,100,104,130,121,0.203125,0.2520833333333333,0.15625,0.21666666666666667
BloodImage_00045.jpg,43.jpg,RBC,184,103,269,184,1,85,81,226,143,0.353125,0.29791666666666666,0.1328125,0.16875
BloodImage_00045.jpg,43.jpg,RBC,343,13,428,94,1,85,81,385,53,0.6015625,0.11041666666666666,0.1328125,0.16875
BloodImage_00045.jpg,43.jpg,RBC,555,139,640,220,1,85,81,597,179,0.9328125,0.3729166666666667,0.1328125,0.16875
BloodImage_00045.jpg,43.jpg,WBC,491,21,633,144,2,142,123,562,82,0.878125,0.17083333333333334,0.221875,0.25625
BloodImage_00045.jpg,43.jpg,RBC,230,183,326,286,1,96,103,278,234,0.434375,0.4875,0.15,0.21458333333333332
BloodImage_00045.jpg,43.jpg,RBC,162,41,258,144,1,96,103,210,92,0.328125,0.19166666666666668,0.15,0.21458333333333332
BloodImage_00045.jpg,43.jpg,Platelets,173,13,204,41,0,31,28,188,27,0.29375,0.05625,0.0484375,0.058333333333333334
BloodImage_00046.jpg,44.jpg,WBC,312,1,453,92,2,141,91,382,46,0.596875,0.09583333333333334,0.2203125,0.18958333333333333
BloodImage_00046.jpg,44.jpg,Platelets,47,237,99,281,0,52,44,73,259,0.1140625,0.5395833333333333,0.08125,0.09166666666666666
BloodImage_00046.jpg,44.jpg,RBC,340,143,473,259,1,133,116,406,201,0.634375,0.41875,0.2078125,0.24166666666666667
BloodImage_00046.jpg,44.jpg,RBC,245,129,358,233,1,113,104,301,181,0.4703125,0.3770833333333333,0.1765625,0.21666666666666667
BloodImage_00046.jpg,44.jpg,RBC,241,29,354,133,1,113,104,297,81,0.4640625,0.16875,0.1765625,0.21666666666666667
BloodImage_00046.jpg,44.jpg,RBC,138,294,251,398,1,113,104,194,346,0.303125,0.7208333333333333,0.1765625,0.21666666666666667
BloodImage_00046.jpg,44.jpg,RBC,61,313,174,417,1,113,104,117,365,0.1828125,0.7604166666666666,0.1765625,0.21666666666666667
BloodImage_00046.jpg,44.jpg,RBC,157,391,262,480,1,105,89,209,435,0.3265625,0.90625,0.1640625,0.18541666666666667
BloodImage_00046.jpg,44.jpg,RBC,218,417,315,480,1,97,63,266,448,0.415625,0.9333333333333333,0.1515625,0.13125
BloodImage_00046.jpg,44.jpg,RBC,1,417,109,480,1,108,63,55,448,0.0859375,0.9333333333333333,0.16875,0.13125
BloodImage_00046.jpg,44.jpg,RBC,521,90,609,181,1,88,91,565,135,0.8828125,0.28125,0.1375,0.18958333333333333
BloodImage_00046.jpg,44.jpg,RBC,479,109,567,200,1,88,91,523,154,0.8171875,0.32083333333333336,0.1375,0.18958333333333333
BloodImage_00046.jpg,44.jpg,RBC,463,172,551,263,1,88,91,507,217,0.7921875,0.45208333333333334,0.1375,0.18958333333333333
BloodImage_00046.jpg,44.jpg,RBC,499,189,587,280,1,88,91,543,234,0.8484375,0.4875,0.1375,0.18958333333333333
BloodImage_00046.jpg,44.jpg,RBC,519,209,607,300,1,88,91,563,254,0.8796875,0.5291666666666667,0.1375,0.18958333333333333
BloodImage_00046.jpg,44.jpg,RBC,532,239,640,337,1,108,98,586,288,0.915625,0.6,0.16875,0.20416666666666666
BloodImage_00046.jpg,44.jpg,RBC,485,398,623,480,1,138,82,554,439,0.865625,0.9145833333333333,0.215625,0.17083333333333334
BloodImage_00046.jpg,44.jpg,RBC,106,22,213,120,1,107,98,159,71,0.2484375,0.14791666666666667,0.1671875,0.20416666666666666
BloodImage_00046.jpg,44.jpg,RBC,1,83,85,189,1,84,106,43,136,0.0671875,0.2833333333333333,0.13125,0.22083333333333333
BloodImage_00046.jpg,44.jpg,RBC,7,1,112,91,1,105,90,59,46,0.0921875,0.09583333333333334,0.1640625,0.1875
BloodImage_00046.jpg,44.jpg,RBC,214,284,328,383,1,114,99,271,333,0.4234375,0.69375,0.178125,0.20625
BloodImage_00046.jpg,44.jpg,RBC,338,296,415,383,1,77,87,376,339,0.5875,0.70625,0.1203125,0.18125
BloodImage_00046.jpg,44.jpg,RBC,334,349,411,436,1,77,87,372,392,0.58125,0.8166666666666667,0.1203125,0.18125
BloodImage_00046.jpg,44.jpg,RBC,269,387,377,480,1,108,93,323,433,0.5046875,0.9020833333333333,0.16875,0.19375
BloodImage_00047.jpg,45.jpg,WBC,278,147,383,259,2,105,112,330,203,0.515625,0.42291666666666666,0.1640625,0.23333333333333334
BloodImage_00047.jpg,45.jpg,Platelets,207,214,240,242,0,33,28,223,228,0.3484375,0.475,0.0515625,0.058333333333333334
BloodImage_00047.jpg,45.jpg,Platelets,258,263,291,291,0,33,28,274,277,0.428125,0.5770833333333333,0.0515625,0.058333333333333334
BloodImage_00047.jpg,45.jpg,Platelets,12,277,40,311,0,28,34,26,294,0.040625,0.6125,0.04375,0.07083333333333333
BloodImage_00047.jpg,45.jpg,RBC,32,102,163,230,1,131,128,97,166,0.1515625,0.3458333333333333,0.2046875,0.26666666666666666
BloodImage_00047.jpg,45.jpg,RBC,19,1,114,90,1,95,89,66,45,0.103125,0.09375,0.1484375,0.18541666666666667
BloodImage_00047.jpg,45.jpg,RBC,1,25,95,115,1,94,90,48,70,0.075,0.14583333333333334,0.146875,0.1875
BloodImage_00047.jpg,45.jpg,RBC,110,25,226,117,1,116,92,168,71,0.2625,0.14791666666666667,0.18125,0.19166666666666668
BloodImage_00047.jpg,45.jpg,RBC,199,1,314,92,1,115,91,256,46,0.4,0.09583333333333334,0.1796875,0.18958333333333333
BloodImage_00047.jpg,45.jpg,RBC,377,273,485,373,1,108,100,431,323,0.6734375,0.6729166666666667,0.16875,0.20833333333333334
BloodImage_00047.jpg,45.jpg,RBC,416,379,506,480,1,90,101,461,429,0.7203125,0.89375,0.140625,0.21041666666666667
BloodImage_00047.jpg,45.jpg,RBC,269,379,359,480,1,90,101,314,429,0.490625,0.89375,0.140625,0.21041666666666667
BloodImage_00047.jpg,45.jpg,RBC,392,177,494,276,1,102,99,443,226,0.6921875,0.4708333333333333,0.159375,0.20625
BloodImage_00047.jpg,45.jpg,RBC,478,47,560,136,1,82,89,519,91,0.8109375,0.18958333333333333,0.128125,0.18541666666666667
BloodImage_00047.jpg,45.jpg,RBC,552,1,640,96,1,88,95,596,48,0.93125,0.1,0.1375,0.19791666666666666
BloodImage_00047.jpg,45.jpg,RBC,290,268,394,375,1,104,107,342,321,0.534375,0.66875,0.1625,0.22291666666666668
BloodImage_00047.jpg,45.jpg,RBC,232,298,336,405,1,104,107,284,351,0.44375,0.73125,0.1625,0.22291666666666668
BloodImage_00047.jpg,45.jpg,RBC,139,318,248,419,1,109,101,193,368,0.3015625,0.7666666666666667,0.1703125,0.21041666666666667
BloodImage_00047.jpg,45.jpg,RBC,296,51,392,142,1,96,91,344,96,0.5375,0.2,0.15,0.18958333333333333
BloodImage_00047.jpg,45.jpg,RBC,371,75,467,166,1,96,91,419,120,0.6546875,0.25,0.15,0.18958333333333333
BloodImage_00047.jpg,45.jpg,RBC,439,1,546,45,1,107,44,492,23,0.76875,0.04791666666666667,0.1671875,0.09166666666666666
BloodImage_00048.jpg,46.jpg,Platelets,506,192,551,232,0,45,40,528,212,0.825,0.44166666666666665,0.0703125,0.08333333333333333
BloodImage_00048.jpg,46.jpg,WBC,200,151,355,303,2,155,152,277,227,0.4328125,0.47291666666666665,0.2421875,0.31666666666666665
BloodImage_00048.jpg,46.jpg,RBC,149,281,295,387,1,146,106,222,334,0.346875,0.6958333333333333,0.228125,0.22083333333333333
BloodImage_00048.jpg,46.jpg,RBC,90,144,193,249,1,103,105,141,196,0.2203125,0.4083333333333333,0.1609375,0.21875
BloodImage_00048.jpg,46.jpg,RBC,1,59,102,164,1,101,105,51,111,0.0796875,0.23125,0.1578125,0.21875
BloodImage_00048.jpg,46.jpg,RBC,1,12,102,117,1,101,105,51,64,0.0796875,0.13333333333333333,0.1578125,0.21875
BloodImage_00048.jpg,46.jpg,RBC,64,1,162,60,1,98,59,113,30,0.1765625,0.0625,0.153125,0.12291666666666666
BloodImage_00048.jpg,46.jpg,RBC,209,72,317,139,1,108,67,263,105,0.4109375,0.21875,0.16875,0.13958333333333334
BloodImage_00048.jpg,46.jpg,RBC,404,259,503,370,1,99,111,453,314,0.7078125,0.6541666666666667,0.1546875,0.23125
BloodImage_00048.jpg,46.jpg,RBC,191,369,290,480,1,99,111,240,424,0.375,0.8833333333333333,0.1546875,0.23125
BloodImage_00048.jpg,46.jpg,RBC,38,246,137,357,1,99,111,87,301,0.1359375,0.6270833333333333,0.1546875,0.23125
BloodImage_00048.jpg,46.jpg,RBC,396,16,512,118,1,116,102,454,67,0.709375,0.13958333333333334,0.18125,0.2125
BloodImage_00048.jpg,46.jpg,RBC,566,96,640,200,1,74,104,603,148,0.9421875,0.30833333333333335,0.115625,0.21666666666666667
BloodImage_00048.jpg,46.jpg,RBC,524,306,640,408,1,116,102,582,357,0.909375,0.74375,0.18125,0.2125
BloodImage_00048.jpg,46.jpg,RBC,548,400,640,480,1,92,80,594,440,0.928125,0.9166666666666666,0.14375,0.16666666666666666
BloodImage_00048.jpg,46.jpg,RBC,380,349,479,460,1,99,111,429,404,0.6703125,0.8416666666666667,0.1546875,0.23125
BloodImage_00048.jpg,46.jpg,RBC,467,414,555,480,1,88,66,511,447,0.7984375,0.93125,0.1375,0.1375
BloodImage_00049.jpg,47.jpg,WBC,156,248,292,363,2,136,115,224,305,0.35,0.6354166666666666,0.2125,0.23958333333333334
BloodImage_00049.jpg,47.jpg,Platelets,140,202,191,250,0,51,48,165,226,0.2578125,0.4708333333333333,0.0796875,0.1
BloodImage_00049.jpg,47.jpg,RBC,486,81,599,196,1,113,115,542,138,0.846875,0.2875,0.1765625,0.23958333333333334
BloodImage_00049.jpg,47.jpg,RBC,423,265,507,356,1,84,91,465,310,0.7265625,0.6458333333333334,0.13125,0.18958333333333333
BloodImage_00049.jpg,47.jpg,RBC,556,347,639,438,1,83,91,597,392,0.9328125,0.8166666666666667,0.1296875,0.18958333333333333
BloodImage_00049.jpg,47.jpg,RBC,368,315,495,430,1,127,115,431,372,0.6734375,0.775,0.1984375,0.23958333333333334
BloodImage_00049.jpg,47.jpg,RBC,261,332,388,447,1,127,115,324,389,0.50625,0.8104166666666667,0.1984375,0.23958333333333334
BloodImage_00049.jpg,47.jpg,RBC,369,171,480,263,1,111,92,424,217,0.6625,0.45208333333333334,0.1734375,0.19166666666666668
BloodImage_00049.jpg,47.jpg,RBC,378,44,485,164,1,107,120,431,104,0.6734375,0.21666666666666667,0.1671875,0.25
BloodImage_00049.jpg,47.jpg,RBC,180,104,278,211,1,98,107,229,157,0.3578125,0.32708333333333334,0.153125,0.22291666666666668
BloodImage_00049.jpg,47.jpg,RBC,58,142,156,249,1,98,107,107,195,0.1671875,0.40625,0.153125,0.22291666666666668
BloodImage_00049.jpg,47.jpg,RBC,1,124,87,267,1,86,143,44,195,0.06875,0.40625,0.134375,0.29791666666666666
BloodImage_00049.jpg,47.jpg,RBC,279,236,377,343,1,98,107,328,289,0.5125,0.6020833333333333,0.153125,0.22291666666666668
BloodImage_00049.jpg,47.jpg,RBC,282,127,380,234,1,98,107,331,180,0.5171875,0.375,0.153125,0.22291666666666668
BloodImage_00049.jpg,47.jpg,RBC,246,1,377,115,1,131,114,311,58,0.4859375,0.12083333333333333,0.2046875,0.2375
BloodImage_00049.jpg,47.jpg,RBC,153,1,254,78,1,101,77,203,39,0.3171875,0.08125,0.1578125,0.16041666666666668
BloodImage_00049.jpg,47.jpg,RBC,453,1,594,108,1,141,107,523,54,0.8171875,0.1125,0.2203125,0.22291666666666668
BloodImage_00049.jpg,47.jpg,RBC,1,241,68,351,1,67,110,34,296,0.053125,0.6166666666666667,0.1046875,0.22916666666666666
BloodImage_00049.jpg,47.jpg,RBC,41,1,139,108,1,98,107,90,54,0.140625,0.1125,0.153125,0.22291666666666668
BloodImage_00050.jpg,48.jpg,RBC,111,149,205,254,1,94,105,158,201,0.246875,0.41875,0.146875,0.21875
BloodImage_00050.jpg,48.jpg,RBC,484,80,593,186,1,109,106,538,133,0.840625,0.27708333333333335,0.1703125,0.22083333333333333
BloodImage_00050.jpg,48.jpg,RBC,365,109,474,215,1,109,106,419,162,0.6546875,0.3375,0.1703125,0.22083333333333333
BloodImage_00050.jpg,48.jpg,RBC,421,301,528,418,1,107,117,474,359,0.740625,0.7479166666666667,0.1671875,0.24375
BloodImage_00050.jpg,48.jpg,RBC,250,313,348,419,1,98,106,299,366,0.4671875,0.7625,0.153125,0.22083333333333333
BloodImage_00050.jpg,48.jpg,RBC,158,317,256,423,1,98,106,207,370,0.3234375,0.7708333333333334,0.153125,0.22083333333333333
BloodImage_00050.jpg,48.jpg,RBC,321,39,424,146,1,103,107,372,92,0.58125,0.19166666666666668,0.1609375,0.22291666666666668
BloodImage_00050.jpg,48.jpg,RBC,29,64,141,169,1,112,105,85,116,0.1328125,0.24166666666666667,0.175,0.21875
BloodImage_00050.jpg,48.jpg,RBC,323,248,449,353,1,126,105,386,300,0.603125,0.625,0.196875,0.21875
BloodImage_00050.jpg,48.jpg,RBC,514,368,612,474,1,98,106,563,421,0.8796875,0.8770833333333333,0.153125,0.22083333333333333
BloodImage_00050.jpg,48.jpg,WBC,172,1,304,117,2,132,116,238,59,0.371875,0.12291666666666666,0.20625,0.24166666666666667
BloodImage_00052.jpg,49.jpg,RBC,214,81,333,183,1,119,102,273,132,0.4265625,0.275,0.1859375,0.2125
BloodImage_00052.jpg,49.jpg,RBC,332,56,423,151,1,91,95,377,103,0.5890625,0.21458333333333332,0.1421875,0.19791666666666666
BloodImage_00052.jpg,49.jpg,RBC,346,157,437,252,1,91,95,391,204,0.6109375,0.425,0.1421875,0.19791666666666666
BloodImage_00052.jpg,49.jpg,RBC,415,241,506,336,1,91,95,460,288,0.71875,0.6,0.1421875,0.19791666666666666
BloodImage_00052.jpg,49.jpg,RBC,175,121,255,201,1,80,80,215,161,0.3359375,0.33541666666666664,0.125,0.16666666666666666
BloodImage_00052.jpg,49.jpg,RBC,448,392,547,480,1,99,88,497,436,0.7765625,0.9083333333333333,0.1546875,0.18333333333333332
BloodImage_00052.jpg,49.jpg,RBC,257,388,372,480,1,115,92,314,434,0.490625,0.9041666666666667,0.1796875,0.19166666666666668
BloodImage_00052.jpg,49.jpg,RBC,6,388,121,480,1,115,92,63,434,0.0984375,0.9041666666666667,0.1796875,0.19166666666666668
BloodImage_00052.jpg,49.jpg,RBC,494,51,609,150,1,115,99,551,100,0.8609375,0.20833333333333334,0.1796875,0.20625
BloodImage_00052.jpg,49.jpg,RBC,375,1,508,80,1,133,79,441,40,0.6890625,0.08333333333333333,0.2078125,0.16458333333333333
BloodImage_00052.jpg,49.jpg,RBC,549,340,640,442,1,91,102,594,391,0.928125,0.8145833333333333,0.1421875,0.2125
BloodImage_00052.jpg,49.jpg,RBC,571,201,640,333,1,69,132,605,267,0.9453125,0.55625,0.1078125,0.275
BloodImage_00052.jpg,49.jpg,RBC,39,84,153,207,1,114,123,96,145,0.15,0.3020833333333333,0.178125,0.25625
BloodImage_00052.jpg,49.jpg,RBC,22,278,136,401,1,114,123,79,339,0.1234375,0.70625,0.178125,0.25625
BloodImage_00052.jpg,49.jpg,WBC,113,232,241,366,2,128,134,177,299,0.2765625,0.6229166666666667,0.2,0.2791666666666667
BloodImage_00052.jpg,49.jpg,Platelets,294,194,338,234,0,44,40,316,214,0.49375,0.44583333333333336,0.06875,0.08333333333333333
BloodImage_00052.jpg,49.jpg,Platelets,241,258,285,298,0,44,40,263,278,0.4109375,0.5791666666666667,0.06875,0.08333333333333333
BloodImage_00052.jpg,49.jpg,RBC,481,236,546,321,1,65,85,513,278,0.8015625,0.5791666666666667,0.1015625,0.17708333333333334
BloodImage_00053.jpg,50.jpg,RBC,259,317,370,429,1,111,112,314,373,0.490625,0.7770833333333333,0.1734375,0.23333333333333334
BloodImage_00053.jpg,50.jpg,RBC,95,343,234,454,1,139,111,164,398,0.25625,0.8291666666666667,0.2171875,0.23125
BloodImage_00053.jpg,50.jpg,RBC,259,57,373,150,1,114,93,316,103,0.49375,0.21458333333333332,0.178125,0.19375
BloodImage_00053.jpg,50.jpg,RBC,559,1,640,87,1,81,86,599,44,0.9359375,0.09166666666666666,0.1265625,0.17916666666666667
BloodImage_00053.jpg,50.jpg,RBC,433,1,541,115,1,108,114,487,58,0.7609375,0.12083333333333333,0.16875,0.2375
BloodImage_00053.jpg,50.jpg,RBC,553,115,640,250,1,87,135,596,182,0.93125,0.37916666666666665,0.1359375,0.28125
BloodImage_00053.jpg,50.jpg,RBC,446,269,533,404,1,87,135,489,336,0.7640625,0.7,0.1359375,0.28125
BloodImage_00053.jpg,50.jpg,RBC,392,125,479,260,1,87,135,435,192,0.6796875,0.4,0.1359375,0.28125
BloodImage_00053.jpg,50.jpg,RBC,1,72,119,200,1,118,128,60,136,0.09375,0.2833333333333333,0.184375,0.26666666666666666
BloodImage_00053.jpg,50.jpg,RBC,529,278,640,390,1,111,112,584,334,0.9125,0.6958333333333333,0.1734375,0.23333333333333334
BloodImage_00053.jpg,50.jpg,WBC,106,12,242,143,2,136,131,174,77,0.271875,0.16041666666666668,0.2125,0.27291666666666664
BloodImage_00053.jpg,50.jpg,Platelets,316,140,362,180,0,46,40,339,160,0.5296875,0.3333333333333333,0.071875,0.08333333333333333
BloodImage_00053.jpg,50.jpg,Platelets,354,215,400,255,0,46,40,377,235,0.5890625,0.4895833333333333,0.071875,0.08333333333333333
BloodImage_00053.jpg,50.jpg,RBC,70,221,181,333,1,111,112,125,277,0.1953125,0.5770833333333333,0.1734375,0.23333333333333334
BloodImage_00054.jpg,51.jpg,RBC,451,19,560,108,1,109,89,505,63,0.7890625,0.13125,0.1703125,0.18541666666666667
BloodImage_00054.jpg,51.jpg,RBC,408,118,514,211,1,106,93,461,164,0.7203125,0.3416666666666667,0.165625,0.19375
BloodImage_00054.jpg,51.jpg,RBC,432,415,573,480,1,141,65,502,447,0.784375,0.93125,0.2203125,0.13541666666666666
BloodImage_00054.jpg,51.jpg,RBC,269,323,373,443,1,104,120,321,383,0.5015625,0.7979166666666667,0.1625,0.25
BloodImage_00054.jpg,51.jpg,RBC,288,138,399,232,1,111,94,343,185,0.5359375,0.3854166666666667,0.1734375,0.19583333333333333
BloodImage_00054.jpg,51.jpg,RBC,533,205,637,325,1,104,120,585,265,0.9140625,0.5520833333333334,0.1625,0.25
BloodImage_00054.jpg,51.jpg,RBC,477,269,600,367,1,123,98,538,318,0.840625,0.6625,0.1921875,0.20416666666666666
BloodImage_00054.jpg,51.jpg,RBC,135,186,219,265,1,84,79,177,225,0.2765625,0.46875,0.13125,0.16458333333333333
BloodImage_00054.jpg,51.jpg,RBC,5,218,114,300,1,109,82,59,259,0.0921875,0.5395833333333333,0.1703125,0.17083333333333334
BloodImage_00054.jpg,51.jpg,RBC,42,340,161,453,1,119,113,101,396,0.1578125,0.825,0.1859375,0.23541666666666666
BloodImage_00054.jpg,51.jpg,WBC,145,61,262,166,2,117,105,203,113,0.3171875,0.23541666666666666,0.1828125,0.21875
BloodImage_00054.jpg,51.jpg,RBC,557,125,640,214,1,83,89,598,169,0.934375,0.35208333333333336,0.1296875,0.18541666666666667
BloodImage_00054.jpg,51.jpg,RBC,282,408,377,480,1,95,72,329,444,0.5140625,0.925,0.1484375,0.15
BloodImage_00054.jpg,51.jpg,RBC,180,343,270,434,1,90,91,225,388,0.3515625,0.8083333333333333,0.140625,0.18958333333333333
BloodImage_00055.jpg,52.jpg,RBC,330,15,439,100,1,109,85,384,57,0.6,0.11875,0.1703125,0.17708333333333334
BloodImage_00055.jpg,52.jpg,RBC,236,20,337,131,1,101,111,286,75,0.446875,0.15625,0.1578125,0.23125
BloodImage_00055.jpg,52.jpg,RBC,319,231,405,327,1,86,96,362,279,0.565625,0.58125,0.134375,0.2
BloodImage_00055.jpg,52.jpg,RBC,487,143,594,265,1,107,122,540,204,0.84375,0.425,0.1671875,0.25416666666666665
BloodImage_00055.jpg,52.jpg,RBC,280,407,366,480,1,86,73,323,443,0.5046875,0.9229166666666667,0.134375,0.15208333333333332
BloodImage_00055.jpg,52.jpg,RBC,211,407,297,480,1,86,73,254,443,0.396875,0.9229166666666667,0.134375,0.15208333333333332
BloodImage_00055.jpg,52.jpg,RBC,555,304,640,415,1,85,111,597,359,0.9328125,0.7479166666666667,0.1328125,0.23125
BloodImage_00055.jpg,52.jpg,RBC,422,283,540,388,1,118,105,481,335,0.7515625,0.6979166666666666,0.184375,0.21875
BloodImage_00055.jpg,52.jpg,RBC,77,1,186,85,1,109,84,131,43,0.2046875,0.08958333333333333,0.1703125,0.175
BloodImage_00055.jpg,52.jpg,RBC,36,12,126,105,1,90,93,81,58,0.1265625,0.12083333333333333,0.140625,0.19375
BloodImage_00055.jpg,52.jpg,WBC,153,134,275,258,2,122,124,214,196,0.334375,0.4083333333333333,0.190625,0.25833333333333336
BloodImage_00055.jpg,52.jpg,Platelets,601,105,634,146,0,33,41,617,125,0.9640625,0.2604166666666667,0.0515625,0.08541666666666667
BloodImage_00055.jpg,52.jpg,Platelets,618,154,640,195,0,22,41,629,174,0.9828125,0.3625,0.034375,0.08541666666666667
BloodImage_00055.jpg,52.jpg,Platelets,535,381,568,422,0,33,41,551,401,0.8609375,0.8354166666666667,0.0515625,0.08541666666666667
BloodImage_00056.jpg,53.jpg,RBC,430,111,539,205,1,109,94,484,158,0.75625,0.32916666666666666,0.1703125,0.19583333333333333
BloodImage_00056.jpg,53.jpg,RBC,329,121,430,212,1,101,91,379,166,0.5921875,0.3458333333333333,0.1578125,0.18958333333333333
BloodImage_00056.jpg,53.jpg,RBC,393,366,494,457,1,101,91,443,411,0.6921875,0.85625,0.1578125,0.18958333333333333
BloodImage_00056.jpg,53.jpg,RBC,37,12,158,137,1,121,125,97,74,0.1515625,0.15416666666666667,0.1890625,0.2604166666666667
BloodImage_00056.jpg,53.jpg,RBC,262,1,409,111,1,147,110,335,56,0.5234375,0.11666666666666667,0.2296875,0.22916666666666666
BloodImage_00056.jpg,53.jpg,RBC,171,204,282,297,1,111,93,226,250,0.353125,0.5208333333333334,0.1734375,0.19375
BloodImage_00056.jpg,53.jpg,RBC,225,312,304,395,1,79,83,264,353,0.4125,0.7354166666666667,0.1234375,0.17291666666666666
BloodImage_00056.jpg,53.jpg,RBC,317,350,416,429,1,99,79,366,389,0.571875,0.8104166666666667,0.1546875,0.16458333333333333
BloodImage_00056.jpg,53.jpg,RBC,507,323,626,436,1,119,113,566,379,0.884375,0.7895833333333333,0.1859375,0.23541666666666666
BloodImage_00056.jpg,53.jpg,RBC,237,99,346,205,1,109,106,291,152,0.4546875,0.31666666666666665,0.1703125,0.22083333333333333
BloodImage_00056.jpg,53.jpg,RBC,420,18,521,129,1,101,111,470,73,0.734375,0.15208333333333332,0.1578125,0.23125
BloodImage_00056.jpg,53.jpg,WBC,274,236,410,355,2,136,119,342,295,0.534375,0.6145833333333334,0.2125,0.24791666666666667
BloodImage_00057.jpg,54.jpg,RBC,488,252,596,357,1,108,105,542,304,0.846875,0.6333333333333333,0.16875,0.21875
BloodImage_00057.jpg,54.jpg,RBC,393,127,487,214,1,94,87,440,170,0.6875,0.3541666666666667,0.146875,0.18125
BloodImage_00057.jpg,54.jpg,RBC,460,64,565,172,1,105,108,512,118,0.8,0.24583333333333332,0.1640625,0.225
BloodImage_00057.jpg,54.jpg,RBC,5,319,110,427,1,105,108,57,373,0.0890625,0.7770833333333333,0.1640625,0.225
BloodImage_00057.jpg,54.jpg,RBC,221,315,322,406,1,101,91,271,360,0.4234375,0.75,0.1578125,0.18958333333333333
BloodImage_00057.jpg,54.jpg,RBC,267,17,364,117,1,97,100,315,67,0.4921875,0.13958333333333334,0.1515625,0.20833333333333334
BloodImage_00057.jpg,54.jpg,WBC,165,71,317,215,2,152,144,241,143,0.3765625,0.29791666666666666,0.2375,0.3
BloodImage_00057.jpg,54.jpg,Platelets,549,405,585,444,0,36,39,567,424,0.8859375,0.8833333333333333,0.05625,0.08125
BloodImage_00057.jpg,54.jpg,Platelets,513,401,549,440,0,36,39,531,420,0.8296875,0.875,0.05625,0.08125
BloodImage_00057.jpg,54.jpg,RBC,322,291,415,391,1,93,100,368,341,0.575,0.7104166666666667,0.1453125,0.20833333333333334
BloodImage_00057.jpg,54.jpg,RBC,410,290,503,390,1,93,100,456,340,0.7125,0.7083333333333334,0.1453125,0.20833333333333334
BloodImage_00058.jpg,55.jpg,RBC,201,223,314,322,1,113,99,257,272,0.4015625,0.5666666666666667,0.1765625,0.20625
BloodImage_00058.jpg,55.jpg,RBC,1,252,89,357,1,88,105,45,304,0.0703125,0.6333333333333333,0.1375,0.21875
BloodImage_00058.jpg,55.jpg,RBC,203,336,292,441,1,89,105,247,388,0.3859375,0.8083333333333333,0.1390625,0.21875
BloodImage_00058.jpg,55.jpg,RBC,507,293,624,422,1,117,129,565,357,0.8828125,0.74375,0.1828125,0.26875
BloodImage_00058.jpg,55.jpg,RBC,464,76,577,175,1,113,99,520,125,0.8125,0.2604166666666667,0.1765625,0.20625
BloodImage_00058.jpg,55.jpg,RBC,6,33,141,169,1,135,136,73,101,0.1140625,0.21041666666666667,0.2109375,0.2833333333333333
BloodImage_00058.jpg,55.jpg,RBC,106,229,188,325,1,82,96,147,277,0.2296875,0.5770833333333333,0.128125,0.2
BloodImage_00058.jpg,55.jpg,RBC,196,146,289,221,1,93,75,242,183,0.378125,0.38125,0.1453125,0.15625
BloodImage_00058.jpg,55.jpg,WBC,211,4,338,132,2,127,128,274,68,0.428125,0.14166666666666666,0.1984375,0.26666666666666666
BloodImage_00058.jpg,55.jpg,Platelets,330,442,373,480,0,43,38,351,461,0.5484375,0.9604166666666667,0.0671875,0.07916666666666666
BloodImage_00059.jpg,56.jpg,RBC,405,191,525,282,1,120,91,465,236,0.7265625,0.49166666666666664,0.1875,0.18958333333333333
BloodImage_00059.jpg,56.jpg,RBC,282,269,402,360,1,120,91,342,314,0.534375,0.6541666666666667,0.1875,0.18958333333333333
BloodImage_00059.jpg,56.jpg,RBC,116,366,236,457,1,120,91,176,411,0.275,0.85625,0.1875,0.18958333333333333
BloodImage_00059.jpg,56.jpg,RBC,27,281,147,372,1,120,91,87,326,0.1359375,0.6791666666666667,0.1875,0.18958333333333333
BloodImage_00059.jpg,56.jpg,RBC,47,95,167,186,1,120,91,107,140,0.1671875,0.2916666666666667,0.1875,0.18958333333333333
BloodImage_00059.jpg,56.jpg,RBC,160,36,256,122,1,96,86,208,79,0.325,0.16458333333333333,0.15,0.17916666666666667
BloodImage_00059.jpg,56.jpg,RBC,409,49,521,141,1,112,92,465,95,0.7265625,0.19791666666666666,0.175,0.19166666666666668
BloodImage_00059.jpg,56.jpg,RBC,228,312,340,420,1,112,108,284,366,0.44375,0.7625,0.175,0.225
BloodImage_00059.jpg,56.jpg,RBC,109,178,221,286,1,112,108,165,232,0.2578125,0.48333333333333334,0.175,0.225
BloodImage_00059.jpg,56.jpg,RBC,293,55,392,160,1,99,105,342,107,0.534375,0.22291666666666668,0.1546875,0.21875
BloodImage_00059.jpg,56.jpg,RBC,49,1,145,82,1,96,81,97,41,0.1515625,0.08541666666666667,0.15,0.16875
BloodImage_00059.jpg,56.jpg,RBC,512,416,619,480,1,107,64,565,448,0.8828125,0.9333333333333333,0.1671875,0.13333333333333333
BloodImage_00059.jpg,56.jpg,WBC,209,173,328,298,2,119,125,268,235,0.41875,0.4895833333333333,0.1859375,0.2604166666666667
BloodImage_00062.jpg,57.jpg,RBC,140,161,264,253,1,124,92,202,207,0.315625,0.43125,0.19375,0.19166666666666668
BloodImage_00062.jpg,57.jpg,RBC,360,283,451,374,1,91,91,405,328,0.6328125,0.6833333333333333,0.1421875,0.18958333333333333
BloodImage_00062.jpg,57.jpg,RBC,429,302,559,418,1,130,116,494,360,0.771875,0.75,0.203125,0.24166666666666667
BloodImage_00062.jpg,57.jpg,RBC,521,231,629,328,1,108,97,575,279,0.8984375,0.58125,0.16875,0.20208333333333334
BloodImage_00062.jpg,57.jpg,RBC,392,153,528,261,1,136,108,460,207,0.71875,0.43125,0.2125,0.225
BloodImage_00062.jpg,57.jpg,RBC,408,56,502,154,1,94,98,455,105,0.7109375,0.21875,0.146875,0.20416666666666666
BloodImage_00062.jpg,57.jpg,RBC,372,1,466,98,1,94,97,419,49,0.6546875,0.10208333333333333,0.146875,0.20208333333333334
BloodImage_00062.jpg,57.jpg,RBC,546,48,640,146,1,94,98,593,97,0.9265625,0.20208333333333334,0.146875,0.20416666666666666
BloodImage_00062.jpg,57.jpg,RBC,173,1,286,93,1,113,92,229,47,0.3578125,0.09791666666666667,0.1765625,0.19166666666666668
BloodImage_00062.jpg,57.jpg,RBC,61,1,160,72,1,99,71,110,36,0.171875,0.075,0.1546875,0.14791666666666667
BloodImage_00062.jpg,57.jpg,RBC,1,25,66,121,1,65,96,33,73,0.0515625,0.15208333333333332,0.1015625,0.2
BloodImage_00062.jpg,57.jpg,WBC,91,261,249,399,2,158,138,170,330,0.265625,0.6875,0.246875,0.2875
BloodImage_00062.jpg,57.jpg,Platelets,264,80,305,125,0,41,45,284,102,0.44375,0.2125,0.0640625,0.09375
BloodImage_00063.jpg,58.jpg,RBC,21,187,118,288,1,97,101,69,237,0.1078125,0.49375,0.1515625,0.21041666666666667
BloodImage_00063.jpg,58.jpg,RBC,194,91,291,192,1,97,101,242,141,0.378125,0.29375,0.1515625,0.21041666666666667
BloodImage_00063.jpg,58.jpg,RBC,543,230,640,331,1,97,101,591,280,0.9234375,0.5833333333333334,0.1515625,0.21041666666666667
BloodImage_00063.jpg,58.jpg,RBC,431,134,548,239,1,117,105,489,186,0.7640625,0.3875,0.1828125,0.21875
BloodImage_00063.jpg,58.jpg,RBC,210,203,303,301,1,93,98,256,252,0.4,0.525,0.1453125,0.20416666666666666
BloodImage_00063.jpg,58.jpg,RBC,118,1,206,81,1,88,80,162,41,0.253125,0.08541666666666667,0.1375,0.16666666666666666
BloodImage_00063.jpg,58.jpg,RBC,169,371,257,452,1,88,81,213,411,0.3328125,0.85625,0.1375,0.16875
BloodImage_00063.jpg,58.jpg,RBC,38,78,163,177,1,125,99,100,127,0.15625,0.26458333333333334,0.1953125,0.20625
BloodImage_00063.jpg,58.jpg,RBC,383,61,483,156,1,100,95,433,108,0.6765625,0.225,0.15625,0.19791666666666666
BloodImage_00063.jpg,58.jpg,WBC,366,295,493,417,2,127,122,429,356,0.6703125,0.7416666666666667,0.1984375,0.25416666666666665
BloodImage_00064.jpg,59.jpg,RBC,474,202,609,309,1,135,107,541,255,0.8453125,0.53125,0.2109375,0.22291666666666668
BloodImage_00064.jpg,59.jpg,RBC,356,248,441,333,1,85,85,398,290,0.621875,0.6041666666666666,0.1328125,0.17708333333333334
BloodImage_00064.jpg,59.jpg,RBC,393,343,494,429,1,101,86,443,386,0.6921875,0.8041666666666667,0.1578125,0.17916666666666667
BloodImage_00064.jpg,59.jpg,RBC,232,150,334,240,1,102,90,283,195,0.4421875,0.40625,0.159375,0.1875
BloodImage_00064.jpg,59.jpg,RBC,416,1,518,90,1,102,89,467,45,0.7296875,0.09375,0.159375,0.18541666666666667
BloodImage_00064.jpg,59.jpg,RBC,204,45,306,135,1,102,90,255,90,0.3984375,0.1875,0.159375,0.1875
BloodImage_00064.jpg,59.jpg,RBC,218,316,320,406,1,102,90,269,361,0.4203125,0.7520833333333333,0.159375,0.1875
BloodImage_00064.jpg,59.jpg,RBC,507,308,612,399,1,105,91,559,353,0.8734375,0.7354166666666667,0.1640625,0.18958333333333333
BloodImage_00064.jpg,59.jpg,RBC,501,406,603,480,1,102,74,552,443,0.8625,0.9229166666666667,0.159375,0.15416666666666667
BloodImage_00064.jpg,59.jpg,RBC,1,228,85,308,1,84,80,43,268,0.0671875,0.5583333333333333,0.13125,0.16666666666666666
BloodImage_00064.jpg,59.jpg,WBC,28,129,172,243,2,144,114,100,186,0.15625,0.3875,0.225,0.2375
BloodImage_00065.jpg,60.jpg,RBC,166,180,266,287,1,100,107,216,233,0.3375,0.48541666666666666,0.15625,0.22291666666666668
BloodImage_00065.jpg,60.jpg,RBC,33,127,133,234,1,100,107,83,180,0.1296875,0.375,0.15625,0.22291666666666668
BloodImage_00065.jpg,60.jpg,RBC,557,150,640,272,1,83,122,598,211,0.934375,0.4395833333333333,0.1296875,0.25416666666666665
BloodImage_00065.jpg,60.jpg,RBC,244,17,337,107,1,93,90,290,62,0.453125,0.12916666666666668,0.1453125,0.1875
BloodImage_00065.jpg,60.jpg,RBC,17,1,111,68,1,94,67,64,34,0.1,0.07083333333333333,0.146875,0.13958333333333334
BloodImage_00065.jpg,60.jpg,WBC,253,275,387,392,2,134,117,320,333,0.5,0.69375,0.209375,0.24375
BloodImage_00065.jpg,60.jpg,WBC,404,107,538,224,2,134,117,471,165,0.7359375,0.34375,0.209375,0.24375
BloodImage_00065.jpg,60.jpg,Platelets,495,298,534,335,0,39,37,514,316,0.803125,0.6583333333333333,0.0609375,0.07708333333333334
BloodImage_00066.jpg,61.jpg,RBC,91,3,194,109,1,103,106,142,56,0.221875,0.11666666666666667,0.1609375,0.22083333333333333
BloodImage_00066.jpg,61.jpg,RBC,92,150,188,259,1,96,109,140,204,0.21875,0.425,0.15,0.22708333333333333
BloodImage_00066.jpg,61.jpg,RBC,469,54,581,150,1,112,96,525,102,0.8203125,0.2125,0.175,0.2
BloodImage_00066.jpg,61.jpg,RBC,377,316,489,412,1,112,96,433,364,0.6765625,0.7583333333333333,0.175,0.2
BloodImage_00066.jpg,61.jpg,RBC,98,367,185,455,1,87,88,141,411,0.2203125,0.85625,0.1359375,0.18333333333333332
BloodImage_00066.jpg,61.jpg,RBC,16,34,103,122,1,87,88,59,78,0.0921875,0.1625,0.1359375,0.18333333333333332
BloodImage_00066.jpg,61.jpg,RBC,289,311,376,399,1,87,88,332,355,0.51875,0.7395833333333334,0.1359375,0.18333333333333332
BloodImage_00066.jpg,61.jpg,RBC,522,407,627,478,1,105,71,574,442,0.896875,0.9208333333333333,0.1640625,0.14791666666666667
BloodImage_00066.jpg,61.jpg,WBC,435,194,577,329,2,142,135,506,261,0.790625,0.54375,0.221875,0.28125
BloodImage_00066.jpg,61.jpg,Platelets,464,136,507,174,0,43,38,485,155,0.7578125,0.3229166666666667,0.0671875,0.07916666666666666
BloodImage_00067.jpg,62.jpg,RBC,20,1,130,107,1,110,106,75,54,0.1171875,0.1125,0.171875,0.22083333333333333
BloodImage_00067.jpg,62.jpg,RBC,140,69,250,176,1,110,107,195,122,0.3046875,0.25416666666666665,0.171875,0.22291666666666668
BloodImage_00067.jpg,62.jpg,RBC,1,329,99,430,1,98,101,50,379,0.078125,0.7895833333333333,0.153125,0.21041666666666667
BloodImage_00067.jpg,62.jpg,RBC,255,188,357,292,1,102,104,306,240,0.478125,0.5,0.159375,0.21666666666666667
BloodImage_00067.jpg,62.jpg,RBC,367,74,469,178,1,102,104,418,126,0.653125,0.2625,0.159375,0.21666666666666667
BloodImage_00067.jpg,62.jpg,RBC,537,131,640,235,1,103,104,588,183,0.91875,0.38125,0.1609375,0.21666666666666667
BloodImage_00067.jpg,62.jpg,RBC,495,229,598,333,1,103,104,546,281,0.853125,0.5854166666666667,0.1609375,0.21666666666666667
BloodImage_00067.jpg,62.jpg,RBC,412,230,500,314,1,88,84,456,272,0.7125,0.5666666666666667,0.1375,0.175
BloodImage_00067.jpg,62.jpg,RBC,440,415,528,480,1,88,65,484,447,0.75625,0.93125,0.1375,0.13541666666666666
BloodImage_00067.jpg,62.jpg,RBC,12,102,114,206,1,102,104,63,154,0.0984375,0.32083333333333336,0.159375,0.21666666666666667
BloodImage_00067.jpg,62.jpg,RBC,81,232,176,353,1,95,121,128,292,0.2,0.6083333333333333,0.1484375,0.2520833333333333
BloodImage_00067.jpg,62.jpg,WBC,137,344,272,471,2,135,127,204,407,0.31875,0.8479166666666667,0.2109375,0.26458333333333334
BloodImage_00068.jpg,63.jpg,RBC,235,23,349,127,1,114,104,292,75,0.45625,0.15625,0.178125,0.21666666666666667
BloodImage_00068.jpg,63.jpg,RBC,388,147,488,243,1,100,96,438,195,0.684375,0.40625,0.15625,0.2
BloodImage_00068.jpg,63.jpg,RBC,482,218,598,338,1,116,120,540,278,0.84375,0.5791666666666667,0.18125,0.25
BloodImage_00068.jpg,63.jpg,RBC,359,259,475,379,1,116,120,417,319,0.6515625,0.6645833333333333,0.18125,0.25
BloodImage_00068.jpg,63.jpg,RBC,34,172,148,243,1,114,71,91,207,0.1421875,0.43125,0.178125,0.14791666666666667
BloodImage_00068.jpg,63.jpg,RBC,283,365,374,450,1,91,85,328,407,0.5125,0.8479166666666667,0.1421875,0.17708333333333334
BloodImage_00068.jpg,63.jpg,RBC,291,299,382,384,1,91,85,336,341,0.525,0.7104166666666667,0.1421875,0.17708333333333334
BloodImage_00068.jpg,63.jpg,RBC,29,394,120,479,1,91,85,74,436,0.115625,0.9083333333333333,0.1421875,0.17708333333333334
BloodImage_00068.jpg,63.jpg,RBC,531,339,622,424,1,91,85,576,381,0.9,0.79375,0.1421875,0.17708333333333334
BloodImage_00068.jpg,63.jpg,WBC,1,224,94,351,2,93,127,47,287,0.0734375,0.5979166666666667,0.1453125,0.26458333333333334
BloodImage_00068.jpg,63.jpg,Platelets,15,107,55,145,0,40,38,35,126,0.0546875,0.2625,0.0625,0.07916666666666666
BloodImage_00068.jpg,63.jpg,Platelets,359,120,393,157,0,34,37,376,138,0.5875,0.2875,0.053125,0.07708333333333334
BloodImage_00068.jpg,63.jpg,Platelets,322,110,356,147,0,34,37,339,128,0.5296875,0.26666666666666666,0.053125,0.07708333333333334
BloodImage_00068.jpg,63.jpg,Platelets,382,89,423,128,0,41,39,402,108,0.628125,0.225,0.0640625,0.08125
BloodImage_00069.jpg,64.jpg,RBC,17,235,114,335,1,97,100,65,285,0.1015625,0.59375,0.1515625,0.20833333333333334
BloodImage_00069.jpg,64.jpg,RBC,210,272,307,372,1,97,100,258,322,0.403125,0.6708333333333333,0.1515625,0.20833333333333334
BloodImage_00069.jpg,64.jpg,RBC,325,134,445,238,1,120,104,385,186,0.6015625,0.3875,0.1875,0.21666666666666667
BloodImage_00069.jpg,64.jpg,RBC,270,57,380,158,1,110,101,325,107,0.5078125,0.22291666666666668,0.171875,0.21041666666666667
BloodImage_00069.jpg,64.jpg,RBC,160,1,283,86,1,123,85,221,43,0.3453125,0.08958333333333333,0.1921875,0.17708333333333334
BloodImage_00069.jpg,64.jpg,RBC,190,153,298,253,1,108,100,244,203,0.38125,0.42291666666666666,0.16875,0.20833333333333334
BloodImage_00069.jpg,64.jpg,RBC,428,379,536,480,1,108,101,482,429,0.753125,0.89375,0.16875,0.21041666666666667
BloodImage_00069.jpg,64.jpg,RBC,477,196,585,297,1,108,101,531,246,0.8296875,0.5125,0.16875,0.21041666666666667
BloodImage_00069.jpg,64.jpg,RBC,487,16,575,98,1,88,82,531,57,0.8296875,0.11875,0.1375,0.17083333333333334
BloodImage_00069.jpg,64.jpg,RBC,525,122,613,204,1,88,82,569,163,0.8890625,0.33958333333333335,0.1375,0.17083333333333334
BloodImage_00069.jpg,64.jpg,RBC,1,321,115,439,1,114,118,58,380,0.090625,0.7916666666666666,0.178125,0.24583333333333332
BloodImage_00069.jpg,64.jpg,RBC,111,308,225,406,1,114,98,168,357,0.2625,0.74375,0.178125,0.20416666666666666
BloodImage_00069.jpg,64.jpg,WBC,341,260,482,385,2,141,125,411,322,0.6421875,0.6708333333333333,0.2203125,0.2604166666666667
BloodImage_00069.jpg,64.jpg,Platelets,306,342,345,373,0,39,31,325,357,0.5078125,0.74375,0.0609375,0.06458333333333334
BloodImage_00069.jpg,64.jpg,Platelets,438,198,474,234,0,36,36,456,216,0.7125,0.45,0.05625,0.075
BloodImage_00070.jpg,65.jpg,RBC,119,394,233,479,1,114,85,176,436,0.275,0.9083333333333333,0.178125,0.17708333333333334
BloodImage_00070.jpg,65.jpg,RBC,187,1,301,85,1,114,84,244,43,0.38125,0.08958333333333333,0.178125,0.175
BloodImage_00070.jpg,65.jpg,RBC,501,230,607,326,1,106,96,554,278,0.865625,0.5791666666666667,0.165625,0.2
BloodImage_00070.jpg,65.jpg,RBC,520,384,626,480,1,106,96,573,432,0.8953125,0.9,0.165625,0.2
BloodImage_00070.jpg,65.jpg,RBC,299,175,414,281,1,115,106,356,228,0.55625,0.475,0.1796875,0.22083333333333333
BloodImage_00070.jpg,65.jpg,RBC,96,21,211,127,1,115,106,153,74,0.2390625,0.15416666666666667,0.1796875,0.22083333333333333
BloodImage_00070.jpg,65.jpg,RBC,45,119,160,225,1,115,106,102,172,0.159375,0.35833333333333334,0.1796875,0.22083333333333333
BloodImage_00070.jpg,65.jpg,RBC,47,263,155,386,1,108,123,101,324,0.1578125,0.675,0.16875,0.25625
BloodImage_00070.jpg,65.jpg,RBC,534,295,640,390,1,106,95,587,342,0.9171875,0.7125,0.165625,0.19791666666666666
BloodImage_00070.jpg,65.jpg,RBC,429,140,535,235,1,106,95,482,187,0.753125,0.38958333333333334,0.165625,0.19791666666666666
BloodImage_00070.jpg,65.jpg,WBC,167,83,296,206,2,129,123,231,144,0.3609375,0.3,0.2015625,0.25625
BloodImage_00070.jpg,65.jpg,WBC,375,348,471,439,2,96,91,423,393,0.6609375,0.81875,0.15,0.18958333333333333
BloodImage_00071.jpg,66.jpg,RBC,300,365,427,474,1,127,109,363,419,0.5671875,0.8729166666666667,0.1984375,0.22708333333333333
BloodImage_00071.jpg,66.jpg,RBC,487,17,614,126,1,127,109,550,71,0.859375,0.14791666666666667,0.1984375,0.22708333333333333
BloodImage_00071.jpg,66.jpg,RBC,160,200,265,300,1,105,100,212,250,0.33125,0.5208333333333334,0.1640625,0.20833333333333334
BloodImage_00071.jpg,66.jpg,RBC,69,8,193,109,1,124,101,131,58,0.2046875,0.12083333333333333,0.19375,0.21041666666666667
BloodImage_00071.jpg,66.jpg,RBC,181,91,286,191,1,105,100,233,141,0.3640625,0.29375,0.1640625,0.20833333333333334
BloodImage_00071.jpg,66.jpg,RBC,82,280,191,394,1,109,114,136,337,0.2125,0.7020833333333333,0.1703125,0.2375
BloodImage_00071.jpg,66.jpg,RBC,509,252,618,366,1,109,114,563,309,0.8796875,0.64375,0.1703125,0.2375
BloodImage_00071.jpg,66.jpg,RBC,83,128,207,253,1,124,125,145,190,0.2265625,0.3958333333333333,0.19375,0.2604166666666667
BloodImage_00071.jpg,66.jpg,WBC,173,358,306,480,2,133,122,239,419,0.3734375,0.8729166666666667,0.2078125,0.25416666666666665
BloodImage_00072.jpg,67.jpg,RBC,204,56,354,155,1,150,99,279,105,0.4359375,0.21875,0.234375,0.20625
BloodImage_00072.jpg,67.jpg,RBC,116,223,214,317,1,98,94,165,270,0.2578125,0.5625,0.153125,0.19583333333333333
BloodImage_00072.jpg,67.jpg,RBC,517,239,610,365,1,93,126,563,302,0.8796875,0.6291666666666667,0.1453125,0.2625
BloodImage_00072.jpg,67.jpg,WBC,189,288,314,408,2,125,120,251,348,0.3921875,0.725,0.1953125,0.25
BloodImage_00073.jpg,68.jpg,RBC,253,385,391,480,1,138,95,322,432,0.503125,0.9,0.215625,0.19791666666666666
BloodImage_00073.jpg,68.jpg,RBC,410,121,529,215,1,119,94,469,168,0.7328125,0.35,0.1859375,0.19583333333333333
BloodImage_00073.jpg,68.jpg,RBC,553,166,640,260,1,87,94,596,213,0.93125,0.44375,0.1359375,0.19583333333333333
BloodImage_00073.jpg,68.jpg,RBC,295,189,387,285,1,92,96,341,237,0.5328125,0.49375,0.14375,0.2
BloodImage_00073.jpg,68.jpg,RBC,169,386,256,480,1,87,94,212,433,0.33125,0.9020833333333333,0.1359375,0.19583333333333333
BloodImage_00073.jpg,68.jpg,RBC,222,288,306,373,1,84,85,264,330,0.4125,0.6875,0.13125,0.17708333333333334
BloodImage_00073.jpg,68.jpg,RBC,24,1,143,91,1,119,90,83,46,0.1296875,0.09583333333333334,0.1859375,0.1875
BloodImage_00073.jpg,68.jpg,RBC,111,237,206,323,1,95,86,158,280,0.246875,0.5833333333333334,0.1484375,0.17916666666666667
BloodImage_00073.jpg,68.jpg,RBC,545,261,640,347,1,95,86,592,304,0.925,0.6333333333333333,0.1484375,0.17916666666666667
BloodImage_00073.jpg,68.jpg,RBC,562,351,640,437,1,78,86,601,394,0.9390625,0.8208333333333333,0.121875,0.17916666666666667
BloodImage_00073.jpg,68.jpg,RBC,365,201,444,276,1,79,75,404,238,0.63125,0.49583333333333335,0.1234375,0.15625
BloodImage_00073.jpg,68.jpg,WBC,211,49,353,177,2,142,128,282,113,0.440625,0.23541666666666666,0.221875,0.26666666666666666
BloodImage_00073.jpg,68.jpg,Platelets,263,194,293,223,0,30,29,278,208,0.434375,0.43333333333333335,0.046875,0.06041666666666667
BloodImage_00073.jpg,68.jpg,Platelets,513,220,543,249,0,30,29,528,234,0.825,0.4875,0.046875,0.06041666666666667
BloodImage_00074.jpg,69.jpg,RBC,87,300,176,396,1,89,96,131,348,0.2046875,0.725,0.1390625,0.2
BloodImage_00074.jpg,69.jpg,RBC,299,180,416,283,1,117,103,357,231,0.5578125,0.48125,0.1828125,0.21458333333333332
BloodImage_00074.jpg,69.jpg,RBC,553,229,640,322,1,87,93,596,275,0.93125,0.5729166666666666,0.1359375,0.19375
BloodImage_00074.jpg,69.jpg,RBC,509,142,613,245,1,104,103,561,193,0.8765625,0.40208333333333335,0.1625,0.21458333333333332
BloodImage_00074.jpg,69.jpg,RBC,499,1,605,101,1,106,100,552,51,0.8625,0.10625,0.165625,0.20833333333333334
BloodImage_00074.jpg,69.jpg,RBC,453,62,559,163,1,106,101,506,112,0.790625,0.23333333333333334,0.165625,0.21041666666666667
BloodImage_00074.jpg,69.jpg,RBC,534,58,640,159,1,106,101,587,108,0.9171875,0.225,0.165625,0.21041666666666667
BloodImage_00074.jpg,69.jpg,RBC,408,239,525,342,1,117,103,466,290,0.728125,0.6041666666666666,0.1828125,0.21458333333333332
BloodImage_00074.jpg,69.jpg,RBC,329,378,418,472,1,89,94,373,425,0.5828125,0.8854166666666666,0.1390625,0.19583333333333333
BloodImage_00074.jpg,69.jpg,RBC,491,398,584,480,1,93,82,537,439,0.8390625,0.9145833333333333,0.1453125,0.17083333333333334
BloodImage_00074.jpg,69.jpg,RBC,406,398,499,480,1,93,82,452,439,0.70625,0.9145833333333333,0.1453125,0.17083333333333334
BloodImage_00074.jpg,69.jpg,RBC,6,398,99,480,1,93,82,52,439,0.08125,0.9145833333333333,0.1453125,0.17083333333333334
BloodImage_00074.jpg,69.jpg,RBC,152,23,235,129,1,83,106,193,76,0.3015625,0.15833333333333333,0.1296875,0.22083333333333333
BloodImage_00074.jpg,69.jpg,WBC,6,10,130,154,2,124,144,68,82,0.10625,0.17083333333333334,0.19375,0.3
BloodImage_00074.jpg,69.jpg,Platelets,331,35,378,75,0,47,40,354,55,0.553125,0.11458333333333333,0.0734375,0.08333333333333333
BloodImage_00075.jpg,70.jpg,RBC,251,167,353,275,1,102,108,302,221,0.471875,0.46041666666666664,0.159375,0.225
BloodImage_00075.jpg,70.jpg,RBC,345,221,447,329,1,102,108,396,275,0.61875,0.5729166666666666,0.159375,0.225
BloodImage_00075.jpg,70.jpg,RBC,251,252,353,360,1,102,108,302,306,0.471875,0.6375,0.159375,0.225
BloodImage_00075.jpg,70.jpg,RBC,148,160,250,268,1,102,108,199,214,0.3109375,0.44583333333333336,0.159375,0.225
BloodImage_00075.jpg,70.jpg,RBC,437,363,556,480,1,119,117,496,421,0.775,0.8770833333333333,0.1859375,0.24375
BloodImage_00075.jpg,70.jpg,RBC,509,242,613,344,1,104,102,561,293,0.8765625,0.6104166666666667,0.1625,0.2125
BloodImage_00075.jpg,70.jpg,RBC,544,1,640,79,1,96,78,592,40,0.925,0.08333333333333333,0.15,0.1625
BloodImage_00075.jpg,70.jpg,RBC,29,167,131,275,1,102,108,80,221,0.125,0.46041666666666664,0.159375,0.225
BloodImage_00075.jpg,70.jpg,RBC,457,246,545,349,1,88,103,501,297,0.7828125,0.61875,0.1375,0.21458333333333332
BloodImage_00075.jpg,70.jpg,RBC,1,1,74,131,1,73,130,37,66,0.0578125,0.1375,0.1140625,0.2708333333333333
BloodImage_00075.jpg,70.jpg,WBC,166,6,325,114,2,159,108,245,60,0.3828125,0.125,0.2484375,0.225
BloodImage_00076.jpg,71.jpg,RBC,216,243,321,333,1,105,90,268,288,0.41875,0.6,0.1640625,0.1875
BloodImage_00076.jpg,71.jpg,RBC,535,184,640,302,1,105,118,587,243,0.9171875,0.50625,0.1640625,0.24583333333333332
BloodImage_00076.jpg,71.jpg,RBC,158,136,284,215,1,126,79,221,175,0.3453125,0.3645833333333333,0.196875,0.16458333333333333
BloodImage_00076.jpg,71.jpg,RBC,221,383,324,464,1,103,81,272,423,0.425,0.88125,0.1609375,0.16875
BloodImage_00076.jpg,71.jpg,RBC,453,50,556,131,1,103,81,504,90,0.7875,0.1875,0.1609375,0.16875
BloodImage_00076.jpg,71.jpg,RBC,309,135,412,216,1,103,81,360,175,0.5625,0.3645833333333333,0.1609375,0.16875
BloodImage_00076.jpg,71.jpg,RBC,1,355,94,448,1,93,93,47,401,0.0734375,0.8354166666666667,0.1453125,0.19375
BloodImage_00076.jpg,71.jpg,RBC,102,1,199,78,1,97,77,150,39,0.234375,0.08125,0.1515625,0.16041666666666668
BloodImage_00076.jpg,71.jpg,RBC,117,398,214,476,1,97,78,165,437,0.2578125,0.9104166666666667,0.1515625,0.1625
BloodImage_00076.jpg,71.jpg,RBC,543,401,640,480,1,97,79,591,440,0.9234375,0.9166666666666666,0.1515625,0.16458333333333333
BloodImage_00076.jpg,71.jpg,RBC,362,390,460,469,1,98,79,411,429,0.6421875,0.89375,0.153125,0.16458333333333333
BloodImage_00076.jpg,71.jpg,WBC,98,235,211,351,2,113,116,154,293,0.240625,0.6104166666666667,0.1765625,0.24166666666666667
BloodImage_00077.jpg,72.jpg,RBC,10,163,94,258,1,84,95,52,210,0.08125,0.4375,0.13125,0.19791666666666666
BloodImage_00077.jpg,72.jpg,RBC,243,200,346,327,1,103,127,294,263,0.459375,0.5479166666666667,0.1609375,0.26458333333333334
BloodImage_00077.jpg,72.jpg,RBC,477,123,580,250,1,103,127,528,186,0.825,0.3875,0.1609375,0.26458333333333334
BloodImage_00077.jpg,72.jpg,RBC,416,316,527,441,1,111,125,471,378,0.7359375,0.7875,0.1734375,0.2604166666666667
BloodImage_00077.jpg,72.jpg,RBC,385,155,480,256,1,95,101,432,205,0.675,0.4270833333333333,0.1484375,0.21041666666666667
BloodImage_00077.jpg,72.jpg,RBC,391,26,486,127,1,95,101,438,76,0.684375,0.15833333333333333,0.1484375,0.21041666666666667
BloodImage_00077.jpg,72.jpg,RBC,1,312,87,412,1,86,100,44,362,0.06875,0.7541666666666667,0.134375,0.20833333333333334
BloodImage_00077.jpg,72.jpg,RBC,566,71,640,171,1,74,100,603,121,0.9421875,0.2520833333333333,0.115625,0.20833333333333334
BloodImage_00077.jpg,72.jpg,WBC,134,92,304,209,2,170,117,219,150,0.3421875,0.3125,0.265625,0.24375
BloodImage_00077.jpg,72.jpg,Platelets,260,364,299,400,0,39,36,279,382,0.4359375,0.7958333333333333,0.0609375,0.075
BloodImage_00077.jpg,72.jpg,Platelets,472,255,511,291,0,39,36,491,273,0.7671875,0.56875,0.0609375,0.075
BloodImage_00078.jpg,73.jpg,RBC,400,247,504,345,1,104,98,452,296,0.70625,0.6166666666666667,0.1625,0.20416666666666666
BloodImage_00078.jpg,73.jpg,RBC,400,306,504,404,1,104,98,452,355,0.70625,0.7395833333333334,0.1625,0.20416666666666666
BloodImage_00078.jpg,73.jpg,RBC,536,189,640,287,1,104,98,588,238,0.91875,0.49583333333333335,0.1625,0.20416666666666666
BloodImage_00078.jpg,73.jpg,RBC,332,1,437,87,1,105,86,384,44,0.6,0.09166666666666666,0.1640625,0.17916666666666667
BloodImage_00078.jpg,73.jpg,RBC,65,37,168,149,1,103,112,116,93,0.18125,0.19375,0.1609375,0.23333333333333334
BloodImage_00078.jpg,73.jpg,RBC,452,8,556,95,1,104,87,504,51,0.7875,0.10625,0.1625,0.18125
BloodImage_00078.jpg,73.jpg,RBC,442,145,546,253,1,104,108,494,199,0.771875,0.41458333333333336,0.1625,0.225
BloodImage_00078.jpg,73.jpg,RBC,252,166,356,264,1,104,98,304,215,0.475,0.4479166666666667,0.1625,0.20416666666666666
BloodImage_00078.jpg,73.jpg,RBC,1,116,79,216,1,78,100,40,166,0.0625,0.3458333333333333,0.121875,0.20833333333333334
BloodImage_00078.jpg,73.jpg,RBC,301,366,402,467,1,101,101,351,416,0.5484375,0.8666666666666667,0.1578125,0.21041666666666667
BloodImage_00078.jpg,73.jpg,RBC,328,92,429,193,1,101,101,378,142,0.590625,0.29583333333333334,0.1578125,0.21041666666666667
BloodImage_00078.jpg,73.jpg,WBC,92,311,257,449,2,165,138,174,380,0.271875,0.7916666666666666,0.2578125,0.2875
BloodImage_00078.jpg,73.jpg,Platelets,173,102,209,138,0,36,36,191,120,0.2984375,0.25,0.05625,0.075
BloodImage_00078.jpg,73.jpg,Platelets,598,399,639,440,0,41,41,618,419,0.965625,0.8729166666666667,0.0640625,0.08541666666666667
BloodImage_00079.jpg,74.jpg,RBC,487,106,602,218,1,115,112,544,162,0.85,0.3375,0.1796875,0.23333333333333334
BloodImage_00079.jpg,74.jpg,RBC,485,217,600,329,1,115,112,542,273,0.846875,0.56875,0.1796875,0.23333333333333334
BloodImage_00079.jpg,74.jpg,RBC,1,323,107,436,1,106,113,54,379,0.084375,0.7895833333333333,0.165625,0.23541666666666666
BloodImage_00079.jpg,74.jpg,RBC,447,322,549,416,1,102,94,498,369,0.778125,0.76875,0.159375,0.19583333333333333
BloodImage_00079.jpg,74.jpg,RBC,229,56,331,150,1,102,94,280,103,0.4375,0.21458333333333332,0.159375,0.19583333333333333
BloodImage_00079.jpg,74.jpg,RBC,1,1,77,65,1,76,64,39,33,0.0609375,0.06875,0.11875,0.13333333333333333
BloodImage_00079.jpg,74.jpg,RBC,323,273,425,350,1,102,77,374,311,0.584375,0.6479166666666667,0.159375,0.16041666666666668
BloodImage_00079.jpg,74.jpg,RBC,142,264,244,341,1,102,77,193,302,0.3015625,0.6291666666666667,0.159375,0.16041666666666668
BloodImage_00079.jpg,74.jpg,RBC,221,148,323,225,1,102,77,272,186,0.425,0.3875,0.159375,0.16041666666666668
BloodImage_00079.jpg,74.jpg,RBC,340,1,442,77,1,102,76,391,39,0.6109375,0.08125,0.159375,0.15833333333333333
BloodImage_00079.jpg,74.jpg,RBC,185,352,288,440,1,103,88,236,396,0.36875,0.825,0.1609375,0.18333333333333332
BloodImage_00079.jpg,74.jpg,RBC,76,103,179,191,1,103,88,127,147,0.1984375,0.30625,0.1609375,0.18333333333333332
BloodImage_00079.jpg,74.jpg,RBC,399,107,506,213,1,107,106,452,160,0.70625,0.3333333333333333,0.1671875,0.22083333333333333
BloodImage_00079.jpg,74.jpg,RBC,361,365,479,469,1,118,104,420,417,0.65625,0.86875,0.184375,0.21666666666666667
BloodImage_00079.jpg,74.jpg,RBC,227,281,302,353,1,75,72,264,317,0.4125,0.6604166666666667,0.1171875,0.15
BloodImage_00079.jpg,74.jpg,WBC,1,199,121,316,2,120,117,61,257,0.0953125,0.5354166666666667,0.1875,0.24375
BloodImage_00079.jpg,74.jpg,Platelets,532,298,558,325,0,26,27,545,311,0.8515625,0.6479166666666667,0.040625,0.05625
BloodImage_00081.jpg,75.jpg,RBC,346,196,456,279,1,110,83,401,237,0.6265625,0.49375,0.171875,0.17291666666666666
BloodImage_00081.jpg,75.jpg,RBC,243,266,353,349,1,110,83,298,307,0.465625,0.6395833333333333,0.171875,0.17291666666666666
BloodImage_00081.jpg,75.jpg,RBC,239,174,343,270,1,104,96,291,222,0.4546875,0.4625,0.1625,0.2
BloodImage_00081.jpg,75.jpg,RBC,232,1,336,88,1,104,87,284,44,0.44375,0.09166666666666666,0.1625,0.18125
BloodImage_00081.jpg,75.jpg,RBC,104,1,211,106,1,107,105,157,53,0.2453125,0.11041666666666666,0.1671875,0.21875
BloodImage_00081.jpg,75.jpg,RBC,299,60,415,162,1,116,102,357,111,0.5578125,0.23125,0.18125,0.2125
BloodImage_00081.jpg,75.jpg,RBC,499,28,613,127,1,114,99,556,77,0.86875,0.16041666666666668,0.178125,0.20625
BloodImage_00081.jpg,75.jpg,RBC,7,287,111,383,1,104,96,59,335,0.0921875,0.6979166666666666,0.1625,0.2
BloodImage_00081.jpg,75.jpg,RBC,210,367,314,463,1,104,96,262,415,0.409375,0.8645833333333334,0.1625,0.2
BloodImage_00081.jpg,75.jpg,RBC,493,98,597,194,1,104,96,545,146,0.8515625,0.30416666666666664,0.1625,0.2
BloodImage_00081.jpg,75.jpg,RBC,444,1,512,67,1,68,66,478,34,0.746875,0.07083333333333333,0.10625,0.1375
BloodImage_00081.jpg,75.jpg,RBC,14,405,95,480,1,81,75,54,442,0.084375,0.9208333333333333,0.1265625,0.15625
BloodImage_00081.jpg,75.jpg,RBC,149,279,235,361,1,86,82,192,320,0.3,0.6666666666666666,0.134375,0.17083333333333334
BloodImage_00081.jpg,75.jpg,RBC,137,382,211,459,1,74,77,174,420,0.271875,0.875,0.115625,0.16041666666666668
BloodImage_00081.jpg,75.jpg,WBC,301,346,451,462,2,150,116,376,404,0.5875,0.8416666666666667,0.234375,0.24166666666666667
BloodImage_00081.jpg,75.jpg,Platelets,358,300,401,345,0,43,45,379,322,0.5921875,0.6708333333333333,0.0671875,0.09375
BloodImage_00081.jpg,75.jpg,Platelets,249,87,292,132,0,43,45,270,109,0.421875,0.22708333333333333,0.0671875,0.09375
BloodImage_00082.jpg,76.jpg,RBC,93,64,212,157,1,119,93,152,110,0.2375,0.22916666666666666,0.1859375,0.19375
BloodImage_00082.jpg,76.jpg,RBC,1,1,93,141,1,92,140,47,71,0.0734375,0.14791666666666667,0.14375,0.2916666666666667
BloodImage_00082.jpg,76.jpg,RBC,15,375,110,475,1,95,100,62,425,0.096875,0.8854166666666666,0.1484375,0.20833333333333334
BloodImage_00082.jpg,76.jpg,RBC,264,223,397,333,1,133,110,330,278,0.515625,0.5791666666666667,0.2078125,0.22916666666666666
BloodImage_00082.jpg,76.jpg,RBC,1,204,133,314,1,132,110,67,259,0.1046875,0.5395833333333333,0.20625,0.22916666666666666
BloodImage_00082.jpg,76.jpg,RBC,477,292,610,402,1,133,110,543,347,0.8484375,0.7229166666666667,0.2078125,0.22916666666666666
BloodImage_00082.jpg,76.jpg,RBC,422,207,522,311,1,100,104,472,259,0.7375,0.5395833333333333,0.15625,0.21666666666666667
BloodImage_00082.jpg,76.jpg,RBC,446,376,546,480,1,100,104,496,428,0.775,0.8916666666666667,0.15625,0.21666666666666667
BloodImage_00082.jpg,76.jpg,RBC,216,99,332,201,1,116,102,274,150,0.428125,0.3125,0.18125,0.2125
BloodImage_00082.jpg,76.jpg,RBC,110,293,226,395,1,116,102,168,344,0.2625,0.7166666666666667,0.18125,0.2125
BloodImage_00082.jpg,76.jpg,WBC,257,335,380,456,2,123,121,318,395,0.496875,0.8229166666666666,0.1921875,0.2520833333333333
BloodImage_00083.jpg,77.jpg,WBC,91,255,272,402,2,181,147,181,328,0.2828125,0.6833333333333333,0.2828125,0.30625
BloodImage_00083.jpg,77.jpg,Platelets,462,83,498,119,0,36,36,480,101,0.75,0.21041666666666667,0.05625,0.075
BloodImage_00083.jpg,77.jpg,Platelets,429,16,482,65,0,53,49,455,40,0.7109375,0.08333333333333333,0.0828125,0.10208333333333333
BloodImage_00083.jpg,77.jpg,Platelets,165,431,201,467,0,36,36,183,449,0.2859375,0.9354166666666667,0.05625,0.075
BloodImage_00083.jpg,77.jpg,RBC,514,267,633,372,1,119,105,573,319,0.8953125,0.6645833333333333,0.1859375,0.21875
BloodImage_00083.jpg,77.jpg,RBC,209,151,328,256,1,119,105,268,203,0.41875,0.42291666666666666,0.1859375,0.21875
BloodImage_00083.jpg,77.jpg,RBC,247,119,366,224,1,119,105,306,171,0.478125,0.35625,0.1859375,0.21875
BloodImage_00083.jpg,77.jpg,RBC,310,135,429,240,1,119,105,369,187,0.5765625,0.38958333333333334,0.1859375,0.21875
BloodImage_00083.jpg,77.jpg,RBC,356,130,475,235,1,119,105,415,182,0.6484375,0.37916666666666665,0.1859375,0.21875
BloodImage_00083.jpg,77.jpg,RBC,399,153,518,258,1,119,105,458,205,0.715625,0.4270833333333333,0.1859375,0.21875
BloodImage_00083.jpg,77.jpg,RBC,437,161,556,266,1,119,105,496,213,0.775,0.44375,0.1859375,0.21875
BloodImage_00083.jpg,77.jpg,RBC,506,137,625,242,1,119,105,565,189,0.8828125,0.39375,0.1859375,0.21875
BloodImage_00083.jpg,77.jpg,RBC,113,1,232,105,1,119,104,172,53,0.26875,0.11041666666666666,0.1859375,0.21666666666666667
BloodImage_00083.jpg,77.jpg,RBC,217,1,336,105,1,119,104,276,53,0.43125,0.11041666666666666,0.1859375,0.21666666666666667
BloodImage_00083.jpg,77.jpg,RBC,292,27,411,132,1,119,105,351,79,0.5484375,0.16458333333333333,0.1859375,0.21875
BloodImage_00083.jpg,77.jpg,RBC,1,182,100,312,1,99,130,50,247,0.078125,0.5145833333333333,0.1546875,0.2708333333333333
BloodImage_00083.jpg,77.jpg,RBC,358,398,478,480,1,120,82,418,439,0.653125,0.9145833333333333,0.1875,0.17083333333333334
BloodImage_00086.jpg,78.jpg,WBC,71,126,192,245,2,121,119,131,185,0.2046875,0.3854166666666667,0.1890625,0.24791666666666667
BloodImage_00086.jpg,78.jpg,Platelets,450,51,490,88,0,40,37,470,69,0.734375,0.14375,0.0625,0.07708333333333334
BloodImage_00086.jpg,78.jpg,Platelets,554,360,594,397,0,40,37,574,378,0.896875,0.7875,0.0625,0.07708333333333334
BloodImage_00086.jpg,78.jpg,Platelets,511,425,551,462,0,40,37,531,443,0.8296875,0.9229166666666667,0.0625,0.07708333333333334
BloodImage_00086.jpg,78.jpg,Platelets,1,204,39,241,0,38,37,20,222,0.03125,0.4625,0.059375,0.07708333333333334
BloodImage_00086.jpg,78.jpg,RBC,428,103,546,202,1,118,99,487,152,0.7609375,0.31666666666666665,0.184375,0.20625
BloodImage_00086.jpg,78.jpg,RBC,305,254,423,353,1,118,99,364,303,0.56875,0.63125,0.184375,0.20625
BloodImage_00086.jpg,78.jpg,RBC,269,368,387,467,1,118,99,328,417,0.5125,0.86875,0.184375,0.20625
BloodImage_00086.jpg,78.jpg,RBC,1,244,118,343,1,117,99,59,293,0.0921875,0.6104166666666667,0.1828125,0.20625
BloodImage_00086.jpg,78.jpg,RBC,1,307,118,406,1,117,99,59,356,0.0921875,0.7416666666666667,0.1828125,0.20625
BloodImage_00086.jpg,78.jpg,RBC,77,424,170,480,1,93,56,123,452,0.1921875,0.9416666666666667,0.1453125,0.11666666666666667
BloodImage_00086.jpg,78.jpg,RBC,191,55,302,184,1,111,129,246,119,0.384375,0.24791666666666667,0.1734375,0.26875
BloodImage_00086.jpg,78.jpg,RBC,239,173,333,266,1,94,93,286,219,0.446875,0.45625,0.146875,0.19375
BloodImage_00086.jpg,78.jpg,RBC,377,327,466,432,1,89,105,421,379,0.6578125,0.7895833333333333,0.1390625,0.21875
BloodImage_00086.jpg,78.jpg,RBC,294,157,388,250,1,94,93,341,203,0.5328125,0.42291666666666666,0.146875,0.19375
BloodImage_00087.jpg,79.jpg,RBC,495,100,605,187,1,110,87,550,143,0.859375,0.29791666666666666,0.171875,0.18125
BloodImage_00087.jpg,79.jpg,RBC,407,88,516,179,1,109,91,461,133,0.7203125,0.27708333333333335,0.1703125,0.18958333333333333
BloodImage_00087.jpg,79.jpg,RBC,351,195,465,307,1,114,112,408,251,0.6375,0.5229166666666667,0.178125,0.23333333333333334
BloodImage_00087.jpg,79.jpg,RBC,373,386,479,480,1,106,94,426,433,0.665625,0.9020833333333333,0.165625,0.19583333333333333
BloodImage_00087.jpg,79.jpg,RBC,127,1,233,93,1,106,92,180,47,0.28125,0.09791666666666667,0.165625,0.19166666666666668
BloodImage_00087.jpg,79.jpg,RBC,296,86,402,179,1,106,93,349,132,0.5453125,0.275,0.165625,0.19375
BloodImage_00087.jpg,79.jpg,RBC,129,347,235,440,1,106,93,182,393,0.284375,0.81875,0.165625,0.19375
BloodImage_00087.jpg,79.jpg,WBC,192,223,296,329,2,104,106,244,276,0.38125,0.575,0.1625,0.22083333333333333
BloodImage_00088.jpg,80.jpg,RBC,413,202,537,317,1,124,115,475,259,0.7421875,0.5395833333333333,0.19375,0.23958333333333334
BloodImage_00088.jpg,80.jpg,RBC,227,372,338,457,1,111,85,282,414,0.440625,0.8625,0.1734375,0.17708333333333334
BloodImage_00088.jpg,80.jpg,RBC,34,2,145,100,1,111,98,89,51,0.1390625,0.10625,0.1734375,0.20416666666666666
BloodImage_00088.jpg,80.jpg,RBC,122,236,233,334,1,111,98,177,285,0.2765625,0.59375,0.1734375,0.20416666666666666
BloodImage_00088.jpg,80.jpg,RBC,367,123,478,221,1,111,98,422,172,0.659375,0.35833333333333334,0.1734375,0.20416666666666666
BloodImage_00088.jpg,80.jpg,RBC,1,139,108,249,1,107,110,54,194,0.084375,0.4041666666666667,0.1671875,0.22916666666666666
BloodImage_00088.jpg,80.jpg,RBC,245,123,356,221,1,111,98,300,172,0.46875,0.35833333333333334,0.1734375,0.20416666666666666
BloodImage_00088.jpg,80.jpg,RBC,526,56,637,154,1,111,98,581,105,0.9078125,0.21875,0.1734375,0.20416666666666666
BloodImage_00088.jpg,80.jpg,RBC,419,1,514,78,1,95,77,466,39,0.728125,0.08125,0.1484375,0.16041666666666668
BloodImage_00088.jpg,80.jpg,RBC,1,300,92,393,1,91,93,46,346,0.071875,0.7208333333333333,0.1421875,0.19375
BloodImage_00088.jpg,80.jpg,WBC,254,225,381,370,2,127,145,317,297,0.4953125,0.61875,0.1984375,0.3020833333333333
BloodImage_00088.jpg,80.jpg,Platelets,61,387,88,415,0,27,28,74,401,0.115625,0.8354166666666667,0.0421875,0.058333333333333334
BloodImage_00088.jpg,80.jpg,Platelets,77,432,103,472,0,26,40,90,452,0.140625,0.9416666666666667,0.040625,0.08333333333333333
BloodImage_00089.jpg,81.jpg,RBC,211,345,321,417,1,110,72,266,381,0.415625,0.79375,0.171875,0.15
BloodImage_00089.jpg,81.jpg,RBC,385,125,495,240,1,110,115,440,182,0.6875,0.37916666666666665,0.171875,0.23958333333333334
BloodImage_00089.jpg,81.jpg,RBC,249,112,359,227,1,110,115,304,169,0.475,0.35208333333333336,0.171875,0.23958333333333334
BloodImage_00089.jpg,81.jpg,RBC,487,159,604,275,1,117,116,545,217,0.8515625,0.45208333333333334,0.1828125,0.24166666666666667
BloodImage_00089.jpg,81.jpg,RBC,204,1,319,103,1,115,102,261,52,0.4078125,0.10833333333333334,0.1796875,0.2125
BloodImage_00089.jpg,81.jpg,RBC,67,286,151,383,1,84,97,109,334,0.1703125,0.6958333333333333,0.13125,0.20208333333333334
BloodImage_00089.jpg,81.jpg,RBC,475,403,566,480,1,91,77,520,441,0.8125,0.91875,0.1421875,0.16041666666666668
BloodImage_00089.jpg,81.jpg,RBC,308,403,426,480,1,118,77,367,441,0.5734375,0.91875,0.184375,0.16041666666666668
BloodImage_00089.jpg,81.jpg,RBC,26,59,129,169,1,103,110,77,114,0.1203125,0.2375,0.1609375,0.22916666666666666
BloodImage_00089.jpg,81.jpg,RBC,1,20,80,146,1,79,126,40,83,0.0625,0.17291666666666666,0.1234375,0.2625
BloodImage_00089.jpg,81.jpg,WBC,306,236,451,374,2,145,138,378,305,0.590625,0.6354166666666666,0.2265625,0.2875
BloodImage_00089.jpg,81.jpg,Platelets,304,217,333,253,0,29,36,318,235,0.496875,0.4895833333333333,0.0453125,0.075
BloodImage_00090.jpg,82.jpg,RBC,230,143,358,243,1,128,100,294,193,0.459375,0.40208333333333335,0.2,0.20833333333333334
BloodImage_00090.jpg,82.jpg,RBC,237,1,348,84,1,111,83,292,42,0.45625,0.0875,0.1734375,0.17291666666666666
BloodImage_00090.jpg,82.jpg,RBC,134,78,245,162,1,111,84,189,120,0.2953125,0.25,0.1734375,0.175
BloodImage_00090.jpg,82.jpg,RBC,80,53,173,136,1,93,83,126,94,0.196875,0.19583333333333333,0.1453125,0.17291666666666666
BloodImage_00090.jpg,82.jpg,RBC,495,1,591,79,1,96,78,543,40,0.8484375,0.08333333333333333,0.15,0.1625
BloodImage_00090.jpg,82.jpg,RBC,106,203,199,287,1,93,84,152,245,0.2375,0.5104166666666666,0.1453125,0.175
BloodImage_00090.jpg,82.jpg,RBC,408,383,501,467,1,93,84,454,425,0.709375,0.8854166666666666,0.1453125,0.175
BloodImage_00090.jpg,82.jpg,RBC,461,374,554,458,1,93,84,507,416,0.7921875,0.8666666666666667,0.1453125,0.175
BloodImage_00090.jpg,82.jpg,RBC,232,377,325,461,1,93,84,278,419,0.434375,0.8729166666666667,0.1453125,0.175
BloodImage_00090.jpg,82.jpg,RBC,471,80,571,189,1,100,109,521,134,0.8140625,0.2791666666666667,0.15625,0.22708333333333333
BloodImage_00090.jpg,82.jpg,RBC,378,1,482,72,1,104,71,430,36,0.671875,0.075,0.1625,0.14791666666666667
BloodImage_00090.jpg,82.jpg,RBC,19,155,119,256,1,100,101,69,205,0.1078125,0.4270833333333333,0.15625,0.21041666666666667
BloodImage_00090.jpg,82.jpg,WBC,240,262,362,389,2,122,127,301,325,0.4703125,0.6770833333333334,0.190625,0.26458333333333334
BloodImage_00090.jpg,82.jpg,Platelets,402,72,440,113,0,38,41,421,92,0.6578125,0.19166666666666668,0.059375,0.08541666666666667
BloodImage_00090.jpg,82.jpg,Platelets,262,74,300,115,0,38,41,281,94,0.4390625,0.19583333333333333,0.059375,0.08541666666666667
BloodImage_00091.jpg,83.jpg,RBC,185,138,294,236,1,109,98,239,187,0.3734375,0.38958333333333334,0.1703125,0.20416666666666666
BloodImage_00091.jpg,83.jpg,RBC,273,155,382,253,1,109,98,327,204,0.5109375,0.425,0.1703125,0.20416666666666666
BloodImage_00091.jpg,83.jpg,RBC,430,227,539,325,1,109,98,484,276,0.75625,0.575,0.1703125,0.20416666666666666
BloodImage_00091.jpg,83.jpg,RBC,522,153,631,251,1,109,98,576,202,0.9,0.42083333333333334,0.1703125,0.20416666666666666
BloodImage_00091.jpg,83.jpg,RBC,325,254,434,352,1,109,98,379,303,0.5921875,0.63125,0.1703125,0.20416666666666666
BloodImage_00091.jpg,83.jpg,RBC,294,305,403,403,1,109,98,348,354,0.54375,0.7375,0.1703125,0.20416666666666666
BloodImage_00091.jpg,83.jpg,RBC,347,28,456,126,1,109,98,401,77,0.6265625,0.16041666666666668,0.1703125,0.20416666666666666
BloodImage_00091.jpg,83.jpg,RBC,459,91,568,189,1,109,98,513,140,0.8015625,0.2916666666666667,0.1703125,0.20416666666666666
BloodImage_00091.jpg,83.jpg,RBC,330,372,439,470,1,109,98,384,421,0.6,0.8770833333333333,0.1703125,0.20416666666666666
BloodImage_00091.jpg,83.jpg,WBC,210,3,342,115,2,132,112,276,59,0.43125,0.12291666666666666,0.20625,0.23333333333333334
BloodImage_00092.jpg,84.jpg,RBC,14,275,115,381,1,101,106,64,328,0.1,0.6833333333333333,0.1578125,0.22083333333333333
BloodImage_00092.jpg,84.jpg,RBC,1,374,101,480,1,100,106,51,427,0.0796875,0.8895833333333333,0.15625,0.22083333333333333
BloodImage_00092.jpg,84.jpg,RBC,343,366,444,472,1,101,106,393,419,0.6140625,0.8729166666666667,0.1578125,0.22083333333333333
BloodImage_00092.jpg,84.jpg,RBC,294,386,384,480,1,90,94,339,433,0.5296875,0.9020833333333333,0.140625,0.19583333333333333
BloodImage_00092.jpg,84.jpg,RBC,333,248,423,342,1,90,94,378,295,0.590625,0.6145833333333334,0.140625,0.19583333333333333
BloodImage_00092.jpg,84.jpg,RBC,198,1,282,133,1,84,132,240,67,0.375,0.13958333333333334,0.13125,0.275
BloodImage_00092.jpg,84.jpg,RBC,460,146,548,253,1,88,107,504,199,0.7875,0.41458333333333336,0.1375,0.22291666666666668
BloodImage_00092.jpg,84.jpg,RBC,495,145,583,252,1,88,107,539,198,0.8421875,0.4125,0.1375,0.22291666666666668
BloodImage_00092.jpg,84.jpg,RBC,543,158,640,260,1,97,102,591,209,0.9234375,0.4354166666666667,0.1515625,0.2125
BloodImage_00092.jpg,84.jpg,RBC,520,267,630,371,1,110,104,575,319,0.8984375,0.6645833333333333,0.171875,0.21666666666666667
BloodImage_00092.jpg,84.jpg,RBC,310,183,399,266,1,89,83,354,224,0.553125,0.4666666666666667,0.1390625,0.17291666666666666
BloodImage_00092.jpg,84.jpg,RBC,533,1,640,74,1,107,73,586,37,0.915625,0.07708333333333334,0.1671875,0.15208333333333332
BloodImage_00092.jpg,84.jpg,WBC,282,42,413,169,2,131,127,347,105,0.5421875,0.21875,0.2046875,0.26458333333333334
BloodImage_00092.jpg,84.jpg,Platelets,485,336,524,368,0,39,32,504,352,0.7875,0.7333333333333333,0.0609375,0.06666666666666667
BloodImage_00093.jpg,85.jpg,RBC,452,200,587,308,1,135,108,519,254,0.8109375,0.5291666666666667,0.2109375,0.225
BloodImage_00093.jpg,85.jpg,RBC,357,319,465,420,1,108,101,411,369,0.6421875,0.76875,0.16875,0.21041666666666667
BloodImage_00093.jpg,85.jpg,RBC,295,379,403,480,1,108,101,349,429,0.5453125,0.89375,0.16875,0.21041666666666667
BloodImage_00093.jpg,85.jpg,RBC,108,222,216,323,1,108,101,162,272,0.253125,0.5666666666666667,0.16875,0.21041666666666667
BloodImage_00093.jpg,85.jpg,RBC,197,379,305,480,1,108,101,251,429,0.3921875,0.89375,0.16875,0.21041666666666667
BloodImage_00093.jpg,85.jpg,RBC,440,24,548,125,1,108,101,494,74,0.771875,0.15416666666666667,0.16875,0.21041666666666667
BloodImage_00093.jpg,85.jpg,RBC,362,1,470,100,1,108,99,416,50,0.65,0.10416666666666667,0.16875,0.20625
BloodImage_00093.jpg,85.jpg,RBC,575,269,640,366,1,65,97,607,317,0.9484375,0.6604166666666667,0.1015625,0.20208333333333334
BloodImage_00093.jpg,85.jpg,RBC,290,113,355,210,1,65,97,322,161,0.503125,0.33541666666666664,0.1015625,0.20208333333333334
BloodImage_00093.jpg,85.jpg,RBC,226,293,331,382,1,105,89,278,337,0.434375,0.7020833333333333,0.1640625,0.18541666666666667
BloodImage_00093.jpg,85.jpg,RBC,1,357,107,473,1,106,116,54,415,0.084375,0.8645833333333334,0.165625,0.24166666666666667
BloodImage_00093.jpg,85.jpg,Platelets,479,290,519,326,0,40,36,499,308,0.7796875,0.6416666666666667,0.0625,0.075
BloodImage_00093.jpg,85.jpg,WBC,9,1,137,103,2,128,102,73,52,0.1140625,0.10833333333333334,0.2,0.2125
BloodImage_00094.jpg,86.jpg,RBC,4,354,119,452,1,115,98,61,403,0.0953125,0.8395833333333333,0.1796875,0.20416666666666666
BloodImage_00094.jpg,86.jpg,RBC,29,233,162,372,1,133,139,95,302,0.1484375,0.6291666666666667,0.2078125,0.28958333333333336
BloodImage_00094.jpg,86.jpg,RBC,39,174,153,267,1,114,93,96,220,0.15,0.4583333333333333,0.178125,0.19375
BloodImage_00094.jpg,86.jpg,RBC,138,168,206,298,1,68,130,172,233,0.26875,0.48541666666666666,0.10625,0.2708333333333333
BloodImage_00094.jpg,86.jpg,RBC,22,1,105,79,1,83,78,63,40,0.0984375,0.08333333333333333,0.1296875,0.1625
BloodImage_00094.jpg,86.jpg,RBC,260,46,363,157,1,103,111,311,101,0.4859375,0.21041666666666667,0.1609375,0.23125
BloodImage_00094.jpg,86.jpg,RBC,383,15,470,100,1,87,85,426,57,0.665625,0.11875,0.1359375,0.17708333333333334
BloodImage_00094.jpg,86.jpg,RBC,169,104,278,191,1,109,87,223,147,0.3484375,0.30625,0.1703125,0.18125
BloodImage_00094.jpg,86.jpg,RBC,194,227,313,315,1,119,88,253,271,0.3953125,0.5645833333333333,0.1859375,0.18333333333333332
BloodImage_00094.jpg,86.jpg,RBC,160,318,275,432,1,115,114,217,375,0.3390625,0.78125,0.1796875,0.2375
BloodImage_00094.jpg,86.jpg,RBC,231,320,346,434,1,115,114,288,377,0.45,0.7854166666666667,0.1796875,0.2375
BloodImage_00094.jpg,86.jpg,RBC,356,301,471,428,1,115,127,413,364,0.6453125,0.7583333333333333,0.1796875,0.26458333333333334
BloodImage_00094.jpg,86.jpg,RBC,94,42,171,174,1,77,132,132,108,0.20625,0.225,0.1203125,0.275
BloodImage_00094.jpg,86.jpg,RBC,3,88,106,179,1,103,91,54,133,0.084375,0.27708333333333335,0.1609375,0.18958333333333333
BloodImage_00094.jpg,86.jpg,RBC,131,3,229,113,1,98,110,180,58,0.28125,0.12083333333333333,0.153125,0.22916666666666666
BloodImage_00094.jpg,86.jpg,RBC,545,167,640,304,1,95,137,592,235,0.925,0.4895833333333333,0.1484375,0.28541666666666665
BloodImage_00094.jpg,86.jpg,RBC,457,420,577,480,1,120,60,517,450,0.8078125,0.9375,0.1875,0.125
BloodImage_00094.jpg,86.jpg,Platelets,460,347,500,393,0,40,46,480,370,0.75,0.7708333333333334,0.0625,0.09583333333333334
BloodImage_00094.jpg,86.jpg,WBC,307,128,536,329,2,229,201,421,228,0.6578125,0.475,0.3578125,0.41875
BloodImage_00095.jpg,87.jpg,RBC,8,209,120,298,1,112,89,64,253,0.1,0.5270833333333333,0.175,0.18541666666666667
BloodImage_00095.jpg,87.jpg,RBC,137,307,244,414,1,107,107,190,360,0.296875,0.75,0.1671875,0.22291666666666668
BloodImage_00095.jpg,87.jpg,RBC,56,266,140,406,1,84,140,98,336,0.153125,0.7,0.13125,0.2916666666666667
BloodImage_00095.jpg,87.jpg,RBC,347,257,465,361,1,118,104,406,309,0.634375,0.64375,0.184375,0.21666666666666667
BloodImage_00095.jpg,87.jpg,RBC,257,328,366,411,1,109,83,311,369,0.4859375,0.76875,0.1703125,0.17291666666666666
BloodImage_00095.jpg,87.jpg,RBC,244,176,332,313,1,88,137,288,244,0.45,0.5083333333333333,0.1375,0.28541666666666665
BloodImage_00095.jpg,87.jpg,RBC,313,162,420,269,1,107,107,366,215,0.571875,0.4479166666666667,0.1671875,0.22291666666666668
BloodImage_00095.jpg,87.jpg,RBC,516,256,633,363,1,117,107,574,309,0.896875,0.64375,0.1828125,0.22291666666666668
BloodImage_00095.jpg,87.jpg,RBC,519,102,636,209,1,117,107,577,155,0.9015625,0.3229166666666667,0.1828125,0.22291666666666668
BloodImage_00095.jpg,87.jpg,RBC,244,407,363,480,1,119,73,303,443,0.4734375,0.9229166666666667,0.1859375,0.15208333333333332
BloodImage_00095.jpg,87.jpg,RBC,130,207,254,293,1,124,86,192,250,0.3,0.5208333333333334,0.19375,0.17916666666666667
BloodImage_00095.jpg,87.jpg,RBC,50,69,173,174,1,123,105,111,121,0.1734375,0.2520833333333333,0.1921875,0.21875
BloodImage_00095.jpg,87.jpg,RBC,407,215,495,298,1,88,83,451,256,0.7046875,0.5333333333333333,0.1375,0.17291666666666666
BloodImage_00095.jpg,87.jpg,RBC,476,1,564,66,1,88,65,520,33,0.8125,0.06875,0.1375,0.13541666666666666
BloodImage_00095.jpg,87.jpg,RBC,363,354,459,480,1,96,126,411,417,0.6421875,0.86875,0.15,0.2625
BloodImage_00095.jpg,87.jpg,Platelets,486,62,535,102,0,49,40,510,82,0.796875,0.17083333333333334,0.0765625,0.08333333333333333
BloodImage_00095.jpg,87.jpg,WBC,193,1,413,186,2,220,185,303,93,0.4734375,0.19375,0.34375,0.3854166666666667
BloodImage_00097.jpg,88.jpg,RBC,451,271,544,365,1,93,94,497,318,0.7765625,0.6625,0.1453125,0.19583333333333333
BloodImage_00097.jpg,88.jpg,RBC,453,340,546,434,1,93,94,499,387,0.7796875,0.80625,0.1453125,0.19583333333333333
BloodImage_00097.jpg,88.jpg,RBC,205,369,302,480,1,97,111,253,424,0.3953125,0.8833333333333333,0.1515625,0.23125
BloodImage_00097.jpg,88.jpg,RBC,270,319,367,430,1,97,111,318,374,0.496875,0.7791666666666667,0.1515625,0.23125
BloodImage_00097.jpg,88.jpg,RBC,164,173,245,279,1,81,106,204,226,0.31875,0.4708333333333333,0.1265625,0.22083333333333333
BloodImage_00097.jpg,88.jpg,RBC,206,52,309,179,1,103,127,257,115,0.4015625,0.23958333333333334,0.1609375,0.26458333333333334
BloodImage_00097.jpg,88.jpg,RBC,61,131,160,236,1,99,105,110,183,0.171875,0.38125,0.1546875,0.21875
BloodImage_00097.jpg,88.jpg,RBC,555,172,640,274,1,85,102,597,223,0.9328125,0.46458333333333335,0.1328125,0.2125
BloodImage_00097.jpg,88.jpg,RBC,37,303,144,403,1,107,100,90,353,0.140625,0.7354166666666667,0.1671875,0.20833333333333334
BloodImage_00097.jpg,88.jpg,RBC,502,57,610,157,1,108,100,556,107,0.86875,0.22291666666666668,0.16875,0.20833333333333334
BloodImage_00097.jpg,88.jpg,RBC,381,2,489,102,1,108,100,435,52,0.6796875,0.10833333333333334,0.16875,0.20833333333333334
BloodImage_00097.jpg,88.jpg,RBC,103,25,193,113,1,90,88,148,69,0.23125,0.14375,0.140625,0.18333333333333332
BloodImage_00097.jpg,88.jpg,RBC,1,32,89,120,1,88,88,45,76,0.0703125,0.15833333333333333,0.1375,0.18333333333333332
BloodImage_00097.jpg,88.jpg,RBC,247,248,352,336,1,105,88,299,292,0.4671875,0.6083333333333333,0.1640625,0.18333333333333332
BloodImage_00097.jpg,88.jpg,RBC,1,138,80,238,1,79,100,40,188,0.0625,0.39166666666666666,0.1234375,0.20833333333333334
BloodImage_00097.jpg,88.jpg,RBC,106,228,182,319,1,76,91,144,273,0.225,0.56875,0.11875,0.18958333333333333
BloodImage_00097.jpg,88.jpg,WBC,268,91,554,286,2,286,195,411,188,0.6421875,0.39166666666666666,0.446875,0.40625
BloodImage_00098.jpg,89.jpg,RBC,371,278,481,380,1,110,102,426,329,0.665625,0.6854166666666667,0.171875,0.2125
BloodImage_00098.jpg,89.jpg,RBC,538,167,636,262,1,98,95,587,214,0.9171875,0.44583333333333336,0.153125,0.19791666666666666
BloodImage_00098.jpg,89.jpg,RBC,497,61,599,159,1,102,98,548,110,0.85625,0.22916666666666666,0.159375,0.20416666666666666
BloodImage_00098.jpg,89.jpg,RBC,105,221,191,322,1,86,101,148,271,0.23125,0.5645833333333333,0.134375,0.21041666666666667
BloodImage_00098.jpg,89.jpg,RBC,225,349,310,434,1,85,85,267,391,0.4171875,0.8145833333333333,0.1328125,0.17708333333333334
BloodImage_00098.jpg,89.jpg,RBC,66,266,152,357,1,86,91,109,311,0.1703125,0.6479166666666667,0.134375,0.18958333333333333
BloodImage_00098.jpg,89.jpg,RBC,1,1,92,72,1,91,71,46,36,0.071875,0.075,0.1421875,0.14791666666666667
BloodImage_00098.jpg,89.jpg,RBC,31,152,114,235,1,83,83,72,193,0.1125,0.40208333333333335,0.1296875,0.17291666666666666
BloodImage_00098.jpg,89.jpg,RBC,377,153,466,244,1,89,91,421,198,0.6578125,0.4125,0.1390625,0.18958333333333333
BloodImage_00098.jpg,89.jpg,RBC,256,28,380,137,1,124,109,318,82,0.496875,0.17083333333333334,0.19375,0.22708333333333333
BloodImage_00098.jpg,89.jpg,RBC,63,43,155,154,1,92,111,109,98,0.1703125,0.20416666666666666,0.14375,0.23125
BloodImage_00098.jpg,89.jpg,RBC,418,64,517,166,1,99,102,467,115,0.7296875,0.23958333333333334,0.1546875,0.2125
BloodImage_00098.jpg,89.jpg,RBC,307,363,396,454,1,89,91,351,408,0.5484375,0.85,0.1390625,0.18958333333333333
BloodImage_00098.jpg,89.jpg,WBC,178,130,360,311,2,182,181,269,220,0.4203125,0.4583333333333333,0.284375,0.3770833333333333
BloodImage_00098.jpg,89.jpg,Platelets,29,414,72,449,0,43,35,50,431,0.078125,0.8979166666666667,0.0671875,0.07291666666666667
BloodImage_00099.jpg,90.jpg,RBC,381,191,475,287,1,94,96,428,239,0.66875,0.4979166666666667,0.146875,0.2
BloodImage_00099.jpg,90.jpg,RBC,144,150,255,249,1,111,99,199,199,0.3109375,0.41458333333333336,0.1734375,0.20625
BloodImage_00099.jpg,90.jpg,RBC,115,214,226,332,1,111,118,170,273,0.265625,0.56875,0.1734375,0.24583333333333332
BloodImage_00099.jpg,90.jpg,RBC,410,244,521,362,1,111,118,465,303,0.7265625,0.63125,0.1734375,0.24583333333333332
BloodImage_00099.jpg,90.jpg,RBC,508,128,601,239,1,93,111,554,183,0.865625,0.38125,0.1453125,0.23125
BloodImage_00099.jpg,90.jpg,RBC,433,12,534,121,1,101,109,483,66,0.7546875,0.1375,0.1578125,0.22708333333333333
BloodImage_00099.jpg,90.jpg,RBC,539,359,640,468,1,101,109,589,413,0.9203125,0.8604166666666667,0.1578125,0.22708333333333333
BloodImage_00099.jpg,90.jpg,RBC,545,263,640,357,1,95,94,592,310,0.925,0.6458333333333334,0.1484375,0.19583333333333333
BloodImage_00099.jpg,90.jpg,RBC,52,330,147,424,1,95,94,99,377,0.1546875,0.7854166666666667,0.1484375,0.19583333333333333
BloodImage_00099.jpg,90.jpg,RBC,291,22,408,112,1,117,90,349,67,0.5453125,0.13958333333333334,0.1828125,0.1875
BloodImage_00099.jpg,90.jpg,RBC,225,361,343,460,1,118,99,284,410,0.44375,0.8541666666666666,0.184375,0.20625
BloodImage_00099.jpg,90.jpg,RBC,384,401,502,480,1,118,79,443,440,0.6921875,0.9166666666666666,0.184375,0.16458333333333333
BloodImage_00099.jpg,90.jpg,RBC,27,1,140,67,1,113,66,83,34,0.1296875,0.07083333333333333,0.1765625,0.1375
BloodImage_00099.jpg,90.jpg,RBC,536,1,640,77,1,104,76,588,39,0.91875,0.08125,0.1625,0.15833333333333333
BloodImage_00099.jpg,90.jpg,RBC,137,338,232,448,1,95,110,184,393,0.2875,0.81875,0.1484375,0.22916666666666666
BloodImage_00099.jpg,90.jpg,WBC,224,229,384,345,2,160,116,304,287,0.475,0.5979166666666667,0.25,0.24166666666666667
BloodImage_00099.jpg,90.jpg,Platelets,336,156,368,184,0,32,28,352,170,0.55,0.3541666666666667,0.05,0.058333333333333334
BloodImage_00099.jpg,90.jpg,Platelets,385,66,418,97,0,33,31,401,81,0.6265625,0.16875,0.0515625,0.06458333333333334
BloodImage_00100.jpg,91.jpg,RBC,229,238,342,330,1,113,92,285,284,0.4453125,0.5916666666666667,0.1765625,0.19166666666666668
BloodImage_00100.jpg,91.jpg,RBC,152,146,268,257,1,116,111,210,201,0.328125,0.41875,0.18125,0.23125
BloodImage_00100.jpg,91.jpg,RBC,150,144,266,255,1,116,111,208,199,0.325,0.41458333333333336,0.18125,0.23125
BloodImage_00100.jpg,91.jpg,RBC,70,197,179,300,1,109,103,124,248,0.19375,0.5166666666666667,0.1703125,0.21458333333333332
BloodImage_00100.jpg,91.jpg,RBC,7,1,103,82,1,96,81,55,41,0.0859375,0.08541666666666667,0.15,0.16875
BloodImage_00100.jpg,91.jpg,RBC,469,28,573,121,1,104,93,521,74,0.8140625,0.15416666666666667,0.1625,0.19375
BloodImage_00100.jpg,91.jpg,RBC,494,137,596,237,1,102,100,545,187,0.8515625,0.38958333333333334,0.159375,0.20833333333333334
BloodImage_00100.jpg,91.jpg,RBC,27,305,111,395,1,84,90,69,350,0.1078125,0.7291666666666666,0.13125,0.1875
BloodImage_00100.jpg,91.jpg,RBC,45,105,129,195,1,84,90,87,150,0.1359375,0.3125,0.13125,0.1875
BloodImage_00100.jpg,91.jpg,RBC,32,191,116,281,1,84,90,74,236,0.115625,0.49166666666666664,0.13125,0.1875
BloodImage_00100.jpg,91.jpg,RBC,339,262,405,367,1,66,105,372,314,0.58125,0.6541666666666667,0.103125,0.21875
BloodImage_00100.jpg,91.jpg,RBC,368,59,460,146,1,92,87,414,102,0.646875,0.2125,0.14375,0.18125
BloodImage_00100.jpg,91.jpg,RBC,415,140,516,226,1,101,86,465,183,0.7265625,0.38125,0.1578125,0.17916666666666667
BloodImage_00100.jpg,91.jpg,RBC,344,412,445,479,1,101,67,394,445,0.615625,0.9270833333333334,0.1578125,0.13958333333333334
BloodImage_00100.jpg,91.jpg,RBC,144,250,234,348,1,90,98,189,299,0.2953125,0.6229166666666667,0.140625,0.20416666666666666
BloodImage_00100.jpg,91.jpg,WBC,398,228,590,431,2,192,203,494,329,0.771875,0.6854166666666667,0.3,0.42291666666666666
BloodImage_00100.jpg,91.jpg,Platelets,306,383,347,421,0,41,38,326,402,0.509375,0.8375,0.0640625,0.07916666666666666
BloodImage_00101.jpg,92.jpg,RBC,122,270,243,377,1,121,107,182,323,0.284375,0.6729166666666667,0.1890625,0.22291666666666668
BloodImage_00101.jpg,92.jpg,RBC,2,128,123,235,1,121,107,62,181,0.096875,0.3770833333333333,0.1890625,0.22291666666666668
BloodImage_00101.jpg,92.jpg,RBC,240,39,361,146,1,121,107,300,92,0.46875,0.19166666666666668,0.1890625,0.22291666666666668
BloodImage_00101.jpg,92.jpg,RBC,354,79,462,179,1,108,100,408,129,0.6375,0.26875,0.16875,0.20833333333333334
BloodImage_00101.jpg,92.jpg,RBC,437,43,545,143,1,108,100,491,93,0.7671875,0.19375,0.16875,0.20833333333333334
BloodImage_00101.jpg,92.jpg,RBC,484,128,591,230,1,107,102,537,179,0.8390625,0.3729166666666667,0.1671875,0.2125
BloodImage_00101.jpg,92.jpg,RBC,118,1,221,93,1,103,92,169,47,0.2640625,0.09791666666666667,0.1609375,0.19166666666666668
BloodImage_00101.jpg,92.jpg,RBC,229,165,349,255,1,120,90,289,210,0.4515625,0.4375,0.1875,0.1875
BloodImage_00101.jpg,92.jpg,RBC,545,41,640,136,1,95,95,592,88,0.925,0.18333333333333332,0.1484375,0.19791666666666666
BloodImage_00101.jpg,92.jpg,RBC,313,196,424,290,1,111,94,368,243,0.575,0.50625,0.1734375,0.19583333333333333
BloodImage_00101.jpg,92.jpg,RBC,206,223,316,329,1,110,106,261,276,0.4078125,0.575,0.171875,0.22083333333333333
BloodImage_00101.jpg,92.jpg,RBC,181,338,276,438,1,95,100,228,388,0.35625,0.8083333333333333,0.1484375,0.20833333333333334
BloodImage_00101.jpg,92.jpg,RBC,440,227,574,295,1,134,68,507,261,0.7921875,0.54375,0.209375,0.14166666666666666
BloodImage_00101.jpg,92.jpg,WBC,364,289,521,432,2,157,143,442,360,0.690625,0.75,0.2453125,0.29791666666666666
BloodImage_00101.jpg,92.jpg,Platelets,271,413,308,447,0,37,34,289,430,0.4515625,0.8958333333333334,0.0578125,0.07083333333333333
BloodImage_00101.jpg,92.jpg,Platelets,543,349,574,378,0,31,29,558,363,0.871875,0.75625,0.0484375,0.06041666666666667
BloodImage_00103.jpg,93.jpg,RBC,349,120,499,206,1,150,86,424,163,0.6625,0.33958333333333335,0.234375,0.17916666666666667
BloodImage_00103.jpg,93.jpg,RBC,343,272,437,357,1,94,85,390,314,0.609375,0.6541666666666667,0.146875,0.17708333333333334
BloodImage_00103.jpg,93.jpg,RBC,184,292,283,378,1,99,86,233,335,0.3640625,0.6979166666666666,0.1546875,0.17916666666666667
BloodImage_00103.jpg,93.jpg,RBC,253,240,352,326,1,99,86,302,283,0.471875,0.5895833333333333,0.1546875,0.17916666666666667
BloodImage_00103.jpg,93.jpg,RBC,408,282,505,393,1,97,111,456,337,0.7125,0.7020833333333333,0.1515625,0.23125
BloodImage_00103.jpg,93.jpg,RBC,143,189,240,290,1,97,101,191,239,0.2984375,0.4979166666666667,0.1515625,0.21041666666666667
BloodImage_00103.jpg,93.jpg,RBC,305,43,404,129,1,99,86,354,86,0.553125,0.17916666666666667,0.1546875,0.17916666666666667
BloodImage_00103.jpg,93.jpg,RBC,373,21,472,107,1,99,86,422,64,0.659375,0.13333333333333333,0.1546875,0.17916666666666667
BloodImage_00103.jpg,93.jpg,RBC,458,50,559,160,1,101,110,508,105,0.79375,0.21875,0.1578125,0.22916666666666666
BloodImage_00103.jpg,93.jpg,RBC,1,197,94,285,1,93,88,47,241,0.0734375,0.5020833333333333,0.1453125,0.18333333333333332
BloodImage_00103.jpg,93.jpg,RBC,1,2,70,103,1,69,101,35,52,0.0546875,0.10833333333333334,0.1078125,0.21041666666666667
BloodImage_00103.jpg,93.jpg,RBC,8,386,110,462,1,102,76,59,424,0.0921875,0.8833333333333333,0.159375,0.15833333333333333
BloodImage_00103.jpg,93.jpg,RBC,558,167,640,251,1,82,84,599,209,0.9359375,0.4354166666666667,0.128125,0.175
BloodImage_00103.jpg,93.jpg,RBC,558,319,640,403,1,82,84,599,361,0.9359375,0.7520833333333333,0.128125,0.175
BloodImage_00103.jpg,93.jpg,RBC,479,415,577,480,1,98,65,528,447,0.825,0.93125,0.153125,0.13541666666666666
BloodImage_00103.jpg,93.jpg,RBC,101,120,201,224,1,100,104,151,172,0.2359375,0.35833333333333334,0.15625,0.21666666666666667
BloodImage_00103.jpg,93.jpg,WBC,135,1,281,104,2,146,103,208,52,0.325,0.10833333333333334,0.228125,0.21458333333333332
BloodImage_00103.jpg,93.jpg,Platelets,45,185,74,211,0,29,26,59,198,0.0921875,0.4125,0.0453125,0.05416666666666667
BloodImage_00104.jpg,94.jpg,RBC,430,82,514,162,1,84,80,472,122,0.7375,0.25416666666666665,0.13125,0.16666666666666666
BloodImage_00104.jpg,94.jpg,RBC,474,1,559,70,1,85,69,516,35,0.80625,0.07291666666666667,0.1328125,0.14375
BloodImage_00104.jpg,94.jpg,RBC,406,1,494,60,1,88,59,450,30,0.703125,0.0625,0.1375,0.12291666666666666
BloodImage_00104.jpg,94.jpg,RBC,413,166,507,265,1,94,99,460,215,0.71875,0.4479166666666667,0.146875,0.20625
BloodImage_00104.jpg,94.jpg,RBC,342,25,429,110,1,87,85,385,67,0.6015625,0.13958333333333334,0.1359375,0.17708333333333334
BloodImage_00104.jpg,94.jpg,RBC,33,158,123,258,1,90,100,78,208,0.121875,0.43333333333333335,0.140625,0.20833333333333334
BloodImage_00104.jpg,94.jpg,RBC,178,177,286,286,1,108,109,232,231,0.3625,0.48125,0.16875,0.22708333333333333
BloodImage_00104.jpg,94.jpg,RBC,88,277,188,381,1,100,104,138,329,0.215625,0.6854166666666667,0.15625,0.21666666666666667
BloodImage_00104.jpg,94.jpg,RBC,61,341,157,435,1,96,94,109,388,0.1703125,0.8083333333333333,0.15,0.19583333333333333
BloodImage_00104.jpg,94.jpg,RBC,83,16,190,117,1,107,101,136,66,0.2125,0.1375,0.1671875,0.21041666666666667
BloodImage_00104.jpg,94.jpg,RBC,521,379,637,480,1,116,101,579,429,0.9046875,0.89375,0.18125,0.21041666666666667
BloodImage_00104.jpg,94.jpg,RBC,490,113,591,215,1,101,102,540,164,0.84375,0.3416666666666667,0.1578125,0.2125
BloodImage_00104.jpg,94.jpg,RBC,496,245,578,343,1,82,98,537,294,0.8390625,0.6125,0.128125,0.20416666666666666
BloodImage_00104.jpg,94.jpg,RBC,494,243,576,341,1,82,98,535,292,0.8359375,0.6083333333333333,0.128125,0.20416666666666666
BloodImage_00104.jpg,94.jpg,Platelets,174,393,217,441,0,43,48,195,417,0.3046875,0.86875,0.0671875,0.1
BloodImage_00104.jpg,94.jpg,WBC,259,259,492,464,2,233,205,375,361,0.5859375,0.7520833333333333,0.3640625,0.4270833333333333
BloodImage_00106.jpg,95.jpg,RBC,82,1,214,79,1,132,78,148,40,0.23125,0.08333333333333333,0.20625,0.1625
BloodImage_00106.jpg,95.jpg,RBC,316,130,404,238,1,88,108,360,184,0.5625,0.38333333333333336,0.1375,0.225
BloodImage_00106.jpg,95.jpg,RBC,281,246,372,339,1,91,93,326,292,0.509375,0.6083333333333333,0.1421875,0.19375
BloodImage_00106.jpg,95.jpg,RBC,395,4,486,96,1,91,92,440,50,0.6875,0.10416666666666667,0.1421875,0.19166666666666668
BloodImage_00106.jpg,95.jpg,RBC,409,356,505,448,1,96,92,457,402,0.7140625,0.8375,0.15,0.19166666666666668
BloodImage_00106.jpg,95.jpg,RBC,559,160,640,253,1,81,93,599,206,0.9359375,0.42916666666666664,0.1265625,0.19375
BloodImage_00106.jpg,95.jpg,RBC,524,26,605,119,1,81,93,564,72,0.88125,0.15,0.1265625,0.19375
BloodImage_00106.jpg,95.jpg,RBC,490,395,580,477,1,90,82,535,436,0.8359375,0.9083333333333333,0.140625,0.17083333333333334
BloodImage_00106.jpg,95.jpg,RBC,46,295,134,408,1,88,113,90,351,0.140625,0.73125,0.1375,0.23541666666666666
BloodImage_00106.jpg,95.jpg,RBC,95,99,190,202,1,95,103,142,150,0.221875,0.3125,0.1484375,0.21458333333333332
BloodImage_00106.jpg,95.jpg,RBC,185,86,276,171,1,91,85,230,128,0.359375,0.26666666666666666,0.1421875,0.17708333333333334
BloodImage_00106.jpg,95.jpg,RBC,98,196,211,299,1,113,103,154,247,0.240625,0.5145833333333333,0.1765625,0.21458333333333332
BloodImage_00106.jpg,95.jpg,RBC,187,267,272,360,1,85,93,229,313,0.3578125,0.6520833333333333,0.1328125,0.19375
BloodImage_00106.jpg,95.jpg,RBC,210,321,301,411,1,91,90,255,366,0.3984375,0.7625,0.1421875,0.1875
BloodImage_00106.jpg,95.jpg,RBC,131,346,238,446,1,107,100,184,396,0.2875,0.825,0.1671875,0.20833333333333334
BloodImage_00106.jpg,95.jpg,WBC,374,181,549,334,2,175,153,461,257,0.7203125,0.5354166666666667,0.2734375,0.31875
BloodImage_00106.jpg,95.jpg,Platelets,249,406,288,447,0,39,41,268,426,0.41875,0.8875,0.0609375,0.08541666666666667
BloodImage_00107.jpg,96.jpg,RBC,298,22,416,130,1,118,108,357,76,0.5578125,0.15833333333333333,0.184375,0.225
BloodImage_00107.jpg,96.jpg,RBC,331,310,449,418,1,118,108,390,364,0.609375,0.7583333333333333,0.184375,0.225
BloodImage_00107.jpg,96.jpg,RBC,263,150,347,231,1,84,81,305,190,0.4765625,0.3958333333333333,0.13125,0.16875
BloodImage_00107.jpg,96.jpg,RBC,204,1,301,105,1,97,104,252,53,0.39375,0.11041666666666666,0.1515625,0.21666666666666667
BloodImage_00107.jpg,96.jpg,RBC,11,89,94,177,1,83,88,52,133,0.08125,0.27708333333333335,0.1296875,0.18333333333333332
BloodImage_00107.jpg,96.jpg,RBC,106,208,189,296,1,83,88,147,252,0.2296875,0.525,0.1296875,0.18333333333333332
BloodImage_00107.jpg,96.jpg,RBC,10,318,93,406,1,83,88,51,362,0.0796875,0.7541666666666667,0.1296875,0.18333333333333332
BloodImage_00107.jpg,96.jpg,RBC,527,124,610,212,1,83,88,568,168,0.8875,0.35,0.1296875,0.18333333333333332
BloodImage_00107.jpg,96.jpg,RBC,528,260,639,371,1,111,111,583,315,0.9109375,0.65625,0.1734375,0.23125
BloodImage_00107.jpg,96.jpg,RBC,428,368,552,480,1,124,112,490,424,0.765625,0.8833333333333333,0.19375,0.23333333333333334
BloodImage_00107.jpg,96.jpg,RBC,44,149,134,234,1,90,85,89,191,0.1390625,0.39791666666666664,0.140625,0.17708333333333334
BloodImage_00107.jpg,96.jpg,RBC,102,40,196,122,1,94,82,149,81,0.2328125,0.16875,0.146875,0.17083333333333334
BloodImage_00107.jpg,96.jpg,Platelets,347,206,391,243,0,44,37,369,224,0.5765625,0.4666666666666667,0.06875,0.07708333333333334
BloodImage_00107.jpg,96.jpg,WBC,157,282,309,435,2,152,153,233,358,0.3640625,0.7458333333333333,0.2375,0.31875
BloodImage_00108.jpg,97.jpg,RBC,339,83,429,166,1,90,83,384,124,0.6,0.25833333333333336,0.140625,0.17291666666666666
BloodImage_00108.jpg,97.jpg,RBC,283,42,374,129,1,91,87,328,85,0.5125,0.17708333333333334,0.1421875,0.18125
BloodImage_00108.jpg,97.jpg,RBC,285,181,383,287,1,98,106,334,234,0.521875,0.4875,0.153125,0.22083333333333333
BloodImage_00108.jpg,97.jpg,RBC,187,217,285,310,1,98,93,236,263,0.36875,0.5479166666666667,0.153125,0.19375
BloodImage_00108.jpg,97.jpg,RBC,401,170,512,279,1,111,109,456,224,0.7125,0.4666666666666667,0.1734375,0.22708333333333333
BloodImage_00108.jpg,97.jpg,RBC,496,219,609,336,1,113,117,552,277,0.8625,0.5770833333333333,0.1765625,0.24375
BloodImage_00108.jpg,97.jpg,RBC,438,261,540,375,1,102,114,489,318,0.7640625,0.6625,0.159375,0.2375
BloodImage_00108.jpg,97.jpg,RBC,530,99,632,213,1,102,114,581,156,0.9078125,0.325,0.159375,0.2375
BloodImage_00108.jpg,97.jpg,RBC,62,217,164,331,1,102,114,113,274,0.1765625,0.5708333333333333,0.159375,0.2375
BloodImage_00108.jpg,97.jpg,RBC,1,154,77,266,1,76,112,39,210,0.0609375,0.4375,0.11875,0.23333333333333334
BloodImage_00108.jpg,97.jpg,RBC,160,99,272,211,1,112,112,216,155,0.3375,0.3229166666666667,0.175,0.23333333333333334
BloodImage_00108.jpg,97.jpg,RBC,344,1,449,58,1,105,57,396,29,0.61875,0.06041666666666667,0.1640625,0.11875
BloodImage_00108.jpg,97.jpg,RBC,452,1,557,58,1,105,57,504,29,0.7875,0.06041666666666667,0.1640625,0.11875
BloodImage_00108.jpg,97.jpg,RBC,185,429,276,480,1,91,51,230,454,0.359375,0.9458333333333333,0.1421875,0.10625
BloodImage_00108.jpg,97.jpg,WBC,247,295,436,449,2,189,154,341,372,0.5328125,0.775,0.2953125,0.32083333333333336
BloodImage_00108.jpg,97.jpg,Platelets,1,41,25,82,0,24,41,13,61,0.0203125,0.12708333333333333,0.0375,0.08541666666666667
BloodImage_00109.jpg,98.jpg,RBC,389,158,486,248,1,97,90,437,203,0.6828125,0.42291666666666666,0.1515625,0.1875
BloodImage_00109.jpg,98.jpg,RBC,500,373,598,465,1,98,92,549,419,0.8578125,0.8729166666666667,0.153125,0.19166666666666668
BloodImage_00109.jpg,98.jpg,RBC,297,155,393,255,1,96,100,345,205,0.5390625,0.4270833333333333,0.15,0.20833333333333334
BloodImage_00109.jpg,98.jpg,RBC,393,3,500,104,1,107,101,446,53,0.696875,0.11041666666666666,0.1671875,0.21041666666666667
BloodImage_00109.jpg,98.jpg,RBC,259,166,354,268,1,95,102,306,217,0.478125,0.45208333333333334,0.1484375,0.2125
BloodImage_00109.jpg,98.jpg,RBC,262,286,362,411,1,100,125,312,348,0.4875,0.725,0.15625,0.2604166666666667
BloodImage_00109.jpg,98.jpg,RBC,102,48,216,159,1,114,111,159,103,0.2484375,0.21458333333333332,0.178125,0.23125
BloodImage_00109.jpg,98.jpg,RBC,37,148,151,237,1,114,89,94,192,0.146875,0.4,0.178125,0.18541666666666667
BloodImage_00109.jpg,98.jpg,RBC,34,229,125,307,1,91,78,79,268,0.1234375,0.5583333333333333,0.1421875,0.1625
BloodImage_00109.jpg,98.jpg,RBC,214,62,309,170,1,95,108,261,116,0.4078125,0.24166666666666667,0.1484375,0.225
BloodImage_00109.jpg,98.jpg,RBC,60,355,164,458,1,104,103,112,406,0.175,0.8458333333333333,0.1625,0.21458333333333332
BloodImage_00109.jpg,98.jpg,WBC,363,251,519,421,2,156,170,441,336,0.6890625,0.7,0.24375,0.3541666666666667
BloodImage_00110.jpg,99.jpg,RBC,364,41,494,165,1,130,124,429,103,0.6703125,0.21458333333333332,0.203125,0.25833333333333336
BloodImage_00110.jpg,99.jpg,RBC,493,146,623,270,1,130,124,558,208,0.871875,0.43333333333333335,0.203125,0.25833333333333336
BloodImage_00110.jpg,99.jpg,RBC,284,202,393,290,1,109,88,338,246,0.528125,0.5125,0.1703125,0.18333333333333332
BloodImage_00110.jpg,99.jpg,RBC,260,17,373,90,1,113,73,316,53,0.49375,0.11041666666666666,0.1765625,0.15208333333333332
BloodImage_00110.jpg,99.jpg,RBC,83,206,171,284,1,88,78,127,245,0.1984375,0.5104166666666666,0.1375,0.1625
BloodImage_00110.jpg,99.jpg,RBC,108,66,210,151,1,102,85,159,108,0.2484375,0.225,0.159375,0.17708333333333334
BloodImage_00110.jpg,99.jpg,RBC,214,372,301,474,1,87,102,257,423,0.4015625,0.88125,0.1359375,0.2125
BloodImage_00110.jpg,99.jpg,RBC,139,287,226,378,1,87,91,182,332,0.284375,0.6916666666666667,0.1359375,0.18958333333333333
BloodImage_00110.jpg,99.jpg,RBC,114,386,216,473,1,102,87,165,429,0.2578125,0.89375,0.159375,0.18125
BloodImage_00110.jpg,99.jpg,RBC,1,83,102,183,1,101,100,51,133,0.0796875,0.27708333333333335,0.1578125,0.20833333333333334
BloodImage_00110.jpg,99.jpg,WBC,268,283,468,455,2,200,172,368,369,0.575,0.76875,0.3125,0.35833333333333334
BloodImage_00110.jpg,99.jpg,Platelets,248,59,278,88,0,30,29,263,73,0.4109375,0.15208333333333332,0.046875,0.06041666666666667
BloodImage_00110.jpg,99.jpg,Platelets,468,49,503,85,0,35,36,485,67,0.7578125,0.13958333333333334,0.0546875,0.075
BloodImage_00111.jpg,100.jpg,RBC,458,198,571,296,1,113,98,514,247,0.803125,0.5145833333333333,0.1765625,0.20416666666666666
BloodImage_00111.jpg,100.jpg,RBC,405,240,518,338,1,113,98,461,289,0.7203125,0.6020833333333333,0.1765625,0.20416666666666666
BloodImage_00111.jpg,100.jpg,RBC,365,40,478,138,1,113,98,421,89,0.6578125,0.18541666666666667,0.1765625,0.20416666666666666
BloodImage_00111.jpg,100.jpg,RBC,512,75,630,188,1,118,113,571,131,0.8921875,0.27291666666666664,0.184375,0.23541666666666666
BloodImage_00111.jpg,100.jpg,RBC,468,71,570,175,1,102,104,519,123,0.8109375,0.25625,0.159375,0.21666666666666667
BloodImage_00111.jpg,100.jpg,RBC,175,169,288,267,1,113,98,231,218,0.3609375,0.45416666666666666,0.1765625,0.20416666666666666
BloodImage_00111.jpg,100.jpg,RBC,278,358,391,456,1,113,98,334,407,0.521875,0.8479166666666667,0.1765625,0.20416666666666666
BloodImage_00111.jpg,100.jpg,RBC,527,306,640,404,1,113,98,583,355,0.9109375,0.7395833333333334,0.1765625,0.20416666666666666
BloodImage_00111.jpg,100.jpg,RBC,229,31,342,129,1,113,98,285,80,0.4453125,0.16666666666666666,0.1765625,0.20416666666666666
BloodImage_00111.jpg,100.jpg,RBC,23,44,136,142,1,113,98,79,93,0.1234375,0.19375,0.1765625,0.20416666666666666
BloodImage_00111.jpg,100.jpg,RBC,21,310,134,408,1,113,98,77,359,0.1203125,0.7479166666666667,0.1765625,0.20416666666666666
BloodImage_00111.jpg,100.jpg,RBC,121,280,234,378,1,113,98,177,329,0.2765625,0.6854166666666667,0.1765625,0.20416666666666666
BloodImage_00111.jpg,100.jpg,RBC,60,382,143,480,1,83,98,101,431,0.1578125,0.8979166666666667,0.1296875,0.20416666666666666
BloodImage_00111.jpg,100.jpg,RBC,50,134,194,254,1,144,120,122,194,0.190625,0.4041666666666667,0.225,0.25
BloodImage_00111.jpg,100.jpg,RBC,399,405,495,480,1,96,75,447,442,0.6984375,0.9208333333333333,0.15,0.15625
BloodImage_00111.jpg,100.jpg,WBC,142,378,258,480,2,116,102,200,429,0.3125,0.89375,0.18125,0.2125
BloodImage_00111.jpg,100.jpg,Platelets,360,85,395,115,0,35,30,377,100,0.5890625,0.20833333333333334,0.0546875,0.0625
BloodImage_00112.jpg,101.jpg,RBC,178,350,278,438,1,100,88,228,394,0.35625,0.8208333333333333,0.15625,0.18333333333333332
BloodImage_00112.jpg,101.jpg,RBC,162,141,262,229,1,100,88,212,185,0.33125,0.3854166666666667,0.15625,0.18333333333333332
BloodImage_00112.jpg,101.jpg,RBC,205,30,314,143,1,109,113,259,86,0.4046875,0.17916666666666667,0.1703125,0.23541666666666666
BloodImage_00112.jpg,101.jpg,RBC,95,1,198,81,1,103,80,146,41,0.228125,0.08541666666666667,0.1609375,0.16666666666666666
BloodImage_00112.jpg,101.jpg,RBC,287,260,389,367,1,102,107,338,313,0.528125,0.6520833333333333,0.159375,0.22291666666666668
BloodImage_00112.jpg,101.jpg,RBC,448,128,550,235,1,102,107,499,181,0.7796875,0.3770833333333333,0.159375,0.22291666666666668
BloodImage_00112.jpg,101.jpg,RBC,430,243,525,337,1,95,94,477,290,0.7453125,0.6041666666666666,0.1484375,0.19583333333333333
BloodImage_00112.jpg,101.jpg,RBC,423,385,518,480,1,95,95,470,432,0.734375,0.9,0.1484375,0.19791666666666666
BloodImage_00112.jpg,101.jpg,RBC,369,18,434,87,1,65,69,401,52,0.6265625,0.10833333333333334,0.1015625,0.14375
BloodImage_00112.jpg,101.jpg,RBC,2,57,98,137,1,96,80,50,97,0.078125,0.20208333333333334,0.15,0.16666666666666666
BloodImage_00112.jpg,101.jpg,RBC,353,123,454,224,1,101,101,403,173,0.6296875,0.36041666666666666,0.1578125,0.21041666666666667
BloodImage_00112.jpg,101.jpg,RBC,22,154,122,242,1,100,88,72,198,0.1125,0.4125,0.15625,0.18333333333333332
BloodImage_00112.jpg,101.jpg,WBC,1,264,161,414,2,160,150,81,339,0.1265625,0.70625,0.25,0.3125
BloodImage_00112.jpg,101.jpg,Platelets,533,108,580,151,0,47,43,556,129,0.86875,0.26875,0.0734375,0.08958333333333333
BloodImage_00112.jpg,101.jpg,RBC,79,168,180,279,1,101,111,129,223,0.2015625,0.46458333333333335,0.1578125,0.23125
BloodImage_00113.jpg,102.jpg,RBC,262,151,366,245,1,104,94,314,198,0.490625,0.4125,0.1625,0.19583333333333333
BloodImage_00113.jpg,102.jpg,RBC,169,23,273,117,1,104,94,221,70,0.3453125,0.14583333333333334,0.1625,0.19583333333333333
BloodImage_00113.jpg,102.jpg,RBC,496,178,584,248,1,88,70,540,213,0.84375,0.44375,0.1375,0.14583333333333334
BloodImage_00113.jpg,102.jpg,RBC,533,285,640,389,1,107,104,586,337,0.915625,0.7020833333333333,0.1671875,0.21666666666666667
BloodImage_00113.jpg,102.jpg,RBC,84,366,193,442,1,109,76,138,404,0.215625,0.8416666666666667,0.1703125,0.15833333333333333
BloodImage_00113.jpg,102.jpg,RBC,10,66,99,184,1,89,118,54,125,0.084375,0.2604166666666667,0.1390625,0.24583333333333332
BloodImage_00113.jpg,102.jpg,RBC,365,151,485,268,1,120,117,425,209,0.6640625,0.4354166666666667,0.1875,0.24375
BloodImage_00113.jpg,102.jpg,RBC,299,265,404,369,1,105,104,351,317,0.5484375,0.6604166666666667,0.1640625,0.21666666666666667
BloodImage_00113.jpg,102.jpg,RBC,573,1,640,70,1,67,69,606,35,0.946875,0.07291666666666667,0.1046875,0.14375
BloodImage_00113.jpg,102.jpg,RBC,377,393,473,476,1,96,83,425,434,0.6640625,0.9041666666666667,0.15,0.17291666666666666
BloodImage_00113.jpg,102.jpg,RBC,11,324,102,410,1,91,86,56,367,0.0875,0.7645833333333333,0.1421875,0.17916666666666667
BloodImage_00113.jpg,102.jpg,WBC,62,204,236,359,2,174,155,149,281,0.2328125,0.5854166666666667,0.271875,0.3229166666666667
BloodImage_00113.jpg,102.jpg,WBC,257,430,288,457,2,31,27,272,443,0.425,0.9229166666666667,0.0484375,0.05625
BloodImage_00114.jpg,103.jpg,RBC,173,194,270,292,1,97,98,221,243,0.3453125,0.50625,0.1515625,0.20416666666666666
BloodImage_00114.jpg,103.jpg,RBC,359,214,456,312,1,97,98,407,263,0.6359375,0.5479166666666667,0.1515625,0.20416666666666666
BloodImage_00114.jpg,103.jpg,RBC,415,230,512,328,1,97,98,463,279,0.7234375,0.58125,0.1515625,0.20416666666666666
BloodImage_00114.jpg,103.jpg,RBC,364,336,473,448,1,109,112,418,392,0.653125,0.8166666666666667,0.1703125,0.23333333333333334
BloodImage_00114.jpg,103.jpg,RBC,240,265,349,377,1,109,112,294,321,0.459375,0.66875,0.1703125,0.23333333333333334
BloodImage_00114.jpg,103.jpg,RBC,159,368,263,465,1,104,97,211,416,0.3296875,0.8666666666666667,0.1625,0.20208333333333334
BloodImage_00114.jpg,103.jpg,RBC,50,407,168,477,1,118,70,109,442,0.1703125,0.9208333333333333,0.184375,0.14583333333333334
BloodImage_00114.jpg,103.jpg,RBC,123,15,249,147,1,126,132,186,81,0.290625,0.16875,0.196875,0.275
BloodImage_00114.jpg,103.jpg,RBC,1,284,97,382,1,96,98,49,333,0.0765625,0.69375,0.15,0.20416666666666666
BloodImage_00114.jpg,103.jpg,RBC,512,167,609,265,1,97,98,560,216,0.875,0.45,0.1515625,0.20416666666666666
BloodImage_00114.jpg,103.jpg,RBC,322,396,410,480,1,88,84,366,438,0.571875,0.9125,0.1375,0.175
BloodImage_00114.jpg,103.jpg,RBC,52,230,156,316,1,104,86,104,273,0.1625,0.56875,0.1625,0.17916666666666667
BloodImage_00114.jpg,103.jpg,RBC,9,127,116,220,1,107,93,62,173,0.096875,0.36041666666666666,0.1671875,0.19375
BloodImage_00114.jpg,103.jpg,RBC,32,1,139,72,1,107,71,85,36,0.1328125,0.075,0.1671875,0.14791666666666667
BloodImage_00114.jpg,103.jpg,WBC,224,74,391,206,2,167,132,307,140,0.4796875,0.2916666666666667,0.2609375,0.275
BloodImage_00115.jpg,104.jpg,RBC,23,294,126,393,1,103,99,74,343,0.115625,0.7145833333333333,0.1609375,0.20625
BloodImage_00115.jpg,104.jpg,RBC,223,119,306,204,1,83,85,264,161,0.4125,0.33541666666666664,0.1296875,0.17708333333333334
BloodImage_00115.jpg,104.jpg,RBC,499,141,602,236,1,103,95,550,188,0.859375,0.39166666666666666,0.1609375,0.19791666666666666
BloodImage_00115.jpg,104.jpg,RBC,117,52,220,147,1,103,95,168,99,0.2625,0.20625,0.1609375,0.19791666666666666
BloodImage_00115.jpg,104.jpg,RBC,472,243,577,354,1,105,111,524,298,0.81875,0.6208333333333333,0.1640625,0.23125
BloodImage_00115.jpg,104.jpg,RBC,556,354,640,439,1,84,85,598,396,0.934375,0.825,0.13125,0.17708333333333334
BloodImage_00115.jpg,104.jpg,RBC,466,405,564,480,1,98,75,515,442,0.8046875,0.9208333333333333,0.153125,0.15625
BloodImage_00115.jpg,104.jpg,RBC,302,434,405,480,1,103,46,353,457,0.5515625,0.9520833333333333,0.1609375,0.09583333333333334
BloodImage_00115.jpg,104.jpg,RBC,165,441,265,480,1,100,39,215,460,0.3359375,0.9583333333333334,0.15625,0.08125
BloodImage_00115.jpg,104.jpg,RBC,1,62,87,144,1,86,82,44,103,0.06875,0.21458333333333332,0.134375,0.17083333333333334
BloodImage_00115.jpg,104.jpg,WBC,200,247,356,396,2,156,149,278,321,0.434375,0.66875,0.24375,0.3104166666666667
BloodImage_00115.jpg,104.jpg,RBC,122,294,206,396,1,84,102,164,345,0.25625,0.71875,0.13125,0.2125
BloodImage_00115.jpg,104.jpg,RBC,110,214,194,316,1,84,102,152,265,0.2375,0.5520833333333334,0.13125,0.2125
BloodImage_00115.jpg,104.jpg,RBC,357,153,446,264,1,89,111,401,208,0.6265625,0.43333333333333335,0.1390625,0.23125
BloodImage_00115.jpg,104.jpg,RBC,288,103,379,198,1,91,95,333,150,0.5203125,0.3125,0.1421875,0.19791666666666666
BloodImage_00117.jpg,105.jpg,RBC,507,63,609,180,1,102,117,558,121,0.871875,0.2520833333333333,0.159375,0.24375
BloodImage_00117.jpg,105.jpg,RBC,426,383,528,480,1,102,97,477,431,0.7453125,0.8979166666666667,0.159375,0.20208333333333334
BloodImage_00117.jpg,105.jpg,RBC,186,54,290,174,1,104,120,238,114,0.371875,0.2375,0.1625,0.25
BloodImage_00117.jpg,105.jpg,RBC,108,1,228,104,1,120,103,168,52,0.2625,0.10833333333333334,0.1875,0.21458333333333332
BloodImage_00117.jpg,105.jpg,RBC,1,1,114,96,1,113,95,57,48,0.0890625,0.1,0.1765625,0.19791666666666666
BloodImage_00117.jpg,105.jpg,RBC,314,5,428,101,1,114,96,371,53,0.5796875,0.11041666666666666,0.178125,0.2
BloodImage_00117.jpg,105.jpg,RBC,61,261,165,359,1,104,98,113,310,0.1765625,0.6458333333333334,0.1625,0.20416666666666666
BloodImage_00117.jpg,105.jpg,RBC,98,393,192,480,1,94,87,145,436,0.2265625,0.9083333333333333,0.146875,0.18125
BloodImage_00117.jpg,105.jpg,Platelets,524,357,574,398,0,50,41,549,377,0.8578125,0.7854166666666667,0.078125,0.08541666666666667
BloodImage_00117.jpg,105.jpg,Platelets,209,310,242,347,0,33,37,225,328,0.3515625,0.6833333333333333,0.0515625,0.07708333333333334
BloodImage_00117.jpg,105.jpg,WBC,242,87,466,301,2,224,214,354,194,0.553125,0.4041666666666667,0.35,0.44583333333333336
BloodImage_00117.jpg,105.jpg,RBC,287,383,396,480,1,109,97,341,431,0.5328125,0.8979166666666667,0.1703125,0.20208333333333334
BloodImage_00117.jpg,105.jpg,RBC,517,405,620,474,1,103,69,568,439,0.8875,0.9145833333333333,0.1609375,0.14375
BloodImage_00120.jpg,106.jpg,RBC,422,191,536,291,1,114,100,479,241,0.7484375,0.5020833333333333,0.178125,0.20833333333333334
BloodImage_00120.jpg,106.jpg,RBC,53,141,192,262,1,139,121,122,201,0.190625,0.41875,0.2171875,0.2520833333333333
BloodImage_00120.jpg,106.jpg,RBC,354,277,480,393,1,126,116,417,335,0.6515625,0.6979166666666666,0.196875,0.24166666666666667
BloodImage_00120.jpg,106.jpg,RBC,223,230,349,346,1,126,116,286,288,0.446875,0.6,0.196875,0.24166666666666667
BloodImage_00120.jpg,106.jpg,RBC,514,358,615,455,1,101,97,564,406,0.88125,0.8458333333333333,0.1578125,0.20208333333333334
BloodImage_00120.jpg,106.jpg,RBC,246,1,344,86,1,98,85,295,43,0.4609375,0.08958333333333333,0.153125,0.17708333333333334
BloodImage_00120.jpg,106.jpg,RBC,100,49,198,135,1,98,86,149,92,0.2328125,0.19166666666666668,0.153125,0.17916666666666667
BloodImage_00120.jpg,106.jpg,RBC,92,290,190,376,1,98,86,141,333,0.2203125,0.69375,0.153125,0.17916666666666667
BloodImage_00120.jpg,106.jpg,RBC,394,388,469,469,1,75,81,431,428,0.6734375,0.8916666666666667,0.1171875,0.16875
BloodImage_00120.jpg,106.jpg,WBC,160,76,334,220,2,174,144,247,148,0.3859375,0.30833333333333335,0.271875,0.3
BloodImage_00123.jpg,107.jpg,RBC,35,377,150,479,1,115,102,92,428,0.14375,0.8916666666666667,0.1796875,0.2125
BloodImage_00123.jpg,107.jpg,RBC,463,119,578,221,1,115,102,520,170,0.8125,0.3541666666666667,0.1796875,0.2125
BloodImage_00123.jpg,107.jpg,RBC,297,126,364,199,1,67,73,330,162,0.515625,0.3375,0.1046875,0.15208333333333332
BloodImage_00123.jpg,107.jpg,RBC,57,293,144,379,1,87,86,100,336,0.15625,0.7,0.1359375,0.17916666666666667
BloodImage_00123.jpg,107.jpg,RBC,34,103,121,189,1,87,86,77,146,0.1203125,0.30416666666666664,0.1359375,0.17916666666666667
BloodImage_00123.jpg,107.jpg,RBC,314,1,401,85,1,87,84,357,43,0.5578125,0.08958333333333333,0.1359375,0.175
BloodImage_00123.jpg,107.jpg,RBC,354,386,441,472,1,87,86,397,429,0.6203125,0.89375,0.1359375,0.17916666666666667
BloodImage_00123.jpg,107.jpg,WBC,268,195,472,378,2,204,183,370,286,0.578125,0.5958333333333333,0.31875,0.38125
BloodImage_00123.jpg,107.jpg,Platelets,142,53,175,80,0,33,27,158,66,0.246875,0.1375,0.0515625,0.05625
BloodImage_00123.jpg,107.jpg,RBC,158,273,281,378,1,123,105,219,325,0.3421875,0.6770833333333334,0.1921875,0.21875
BloodImage_00124.jpg,108.jpg,RBC,297,131,374,222,1,77,91,335,176,0.5234375,0.36666666666666664,0.1203125,0.18958333333333333
BloodImage_00124.jpg,108.jpg,RBC,473,217,599,313,1,126,96,536,265,0.8375,0.5520833333333334,0.196875,0.2
BloodImage_00124.jpg,108.jpg,RBC,360,126,463,237,1,103,111,411,181,0.6421875,0.3770833333333333,0.1609375,0.23125
BloodImage_00124.jpg,108.jpg,RBC,144,184,275,322,1,131,138,209,253,0.3265625,0.5270833333333333,0.2046875,0.2875
BloodImage_00124.jpg,108.jpg,RBC,37,279,104,377,1,67,98,70,328,0.109375,0.6833333333333333,0.1046875,0.20416666666666666
BloodImage_00124.jpg,108.jpg,RBC,476,46,543,144,1,67,98,509,95,0.7953125,0.19791666666666666,0.1046875,0.20416666666666666
BloodImage_00124.jpg,108.jpg,RBC,529,319,602,415,1,73,96,565,367,0.8828125,0.7645833333333333,0.1140625,0.2
BloodImage_00124.jpg,108.jpg,RBC,9,406,114,480,1,105,74,61,443,0.0953125,0.9229166666666667,0.1640625,0.15416666666666667
BloodImage_00124.jpg,108.jpg,RBC,207,284,312,374,1,105,90,259,329,0.4046875,0.6854166666666667,0.1640625,0.1875
BloodImage_00124.jpg,108.jpg,WBC,295,292,490,447,2,195,155,392,369,0.6125,0.76875,0.3046875,0.3229166666666667
BloodImage_00124.jpg,108.jpg,Platelets,153,425,184,458,0,31,33,168,441,0.2625,0.91875,0.0484375,0.06875
BloodImage_00124.jpg,108.jpg,RBC,377,46,473,142,1,96,96,425,94,0.6640625,0.19583333333333333,0.15,0.2
BloodImage_00125.jpg,109.jpg,RBC,333,174,421,274,1,88,100,377,224,0.5890625,0.4666666666666667,0.1375,0.20833333333333334
BloodImage_00125.jpg,109.jpg,RBC,312,16,416,119,1,104,103,364,67,0.56875,0.13958333333333334,0.1625,0.21458333333333332
BloodImage_00125.jpg,109.jpg,RBC,173,51,252,140,1,79,89,212,95,0.33125,0.19791666666666666,0.1234375,0.18541666666666667
BloodImage_00125.jpg,109.jpg,RBC,453,291,538,383,1,85,92,495,337,0.7734375,0.7020833333333333,0.1328125,0.19166666666666668
BloodImage_00125.jpg,109.jpg,RBC,408,219,501,315,1,93,96,454,267,0.709375,0.55625,0.1453125,0.2
BloodImage_00125.jpg,109.jpg,RBC,460,119,553,215,1,93,96,506,167,0.790625,0.34791666666666665,0.1453125,0.2
BloodImage_00125.jpg,109.jpg,RBC,287,369,394,480,1,107,111,340,424,0.53125,0.8833333333333333,0.1671875,0.23125
BloodImage_00125.jpg,109.jpg,RBC,1,204,68,310,1,67,106,34,257,0.053125,0.5354166666666667,0.1046875,0.22083333333333333
BloodImage_00125.jpg,109.jpg,RBC,201,355,303,469,1,102,114,252,412,0.39375,0.8583333333333333,0.159375,0.2375
BloodImage_00125.jpg,109.jpg,RBC,28,12,119,120,1,91,108,73,66,0.1140625,0.1375,0.1421875,0.225
BloodImage_00125.jpg,109.jpg,WBC,104,149,275,302,2,171,153,189,225,0.2953125,0.46875,0.2671875,0.31875
BloodImage_00125.jpg,109.jpg,Platelets,511,253,544,285,0,33,32,527,269,0.8234375,0.5604166666666667,0.0515625,0.06666666666666667
BloodImage_00125.jpg,109.jpg,Platelets,170,15,202,55,0,32,40,186,35,0.290625,0.07291666666666667,0.05,0.08333333333333333
BloodImage_00125.jpg,109.jpg,Platelets,50,77,69,100,0,19,23,59,88,0.0921875,0.18333333333333332,0.0296875,0.04791666666666667
BloodImage_00125.jpg,109.jpg,Platelets,376,142,411,174,0,35,32,393,158,0.6140625,0.32916666666666666,0.0546875,0.06666666666666667
BloodImage_00126.jpg,110.jpg,RBC,307,235,409,328,1,102,93,358,281,0.559375,0.5854166666666667,0.159375,0.19375
BloodImage_00126.jpg,110.jpg,RBC,330,133,442,227,1,112,94,386,180,0.603125,0.375,0.175,0.19583333333333333
BloodImage_00126.jpg,110.jpg,RBC,192,150,302,260,1,110,110,247,205,0.3859375,0.4270833333333333,0.171875,0.22916666666666666
BloodImage_00126.jpg,110.jpg,RBC,254,1,366,93,1,112,92,310,47,0.484375,0.09791666666666667,0.175,0.19166666666666668
BloodImage_00126.jpg,110.jpg,RBC,52,16,140,112,1,88,96,96,64,0.15,0.13333333333333333,0.1375,0.2
BloodImage_00126.jpg,110.jpg,RBC,27,253,136,344,1,109,91,81,298,0.1265625,0.6208333333333333,0.1703125,0.18958333333333333
BloodImage_00126.jpg,110.jpg,RBC,334,58,443,149,1,109,91,388,103,0.60625,0.21458333333333332,0.1703125,0.18958333333333333
BloodImage_00126.jpg,110.jpg,RBC,252,317,359,418,1,107,101,305,367,0.4765625,0.7645833333333333,0.1671875,0.21041666666666667
BloodImage_00126.jpg,110.jpg,RBC,200,266,293,391,1,93,125,246,328,0.384375,0.6833333333333333,0.1453125,0.2604166666666667
BloodImage_00126.jpg,110.jpg,RBC,477,165,590,238,1,113,73,533,201,0.8328125,0.41875,0.1765625,0.15208333333333332
BloodImage_00126.jpg,110.jpg,RBC,444,129,550,204,1,106,75,497,166,0.7765625,0.3458333333333333,0.165625,0.15625
BloodImage_00126.jpg,110.jpg,WBC,400,370,547,480,2,147,110,473,425,0.7390625,0.8854166666666666,0.2296875,0.22916666666666666
BloodImage_00127.jpg,111.jpg,RBC,9,249,109,357,1,100,108,59,303,0.0921875,0.63125,0.15625,0.225
BloodImage_00127.jpg,111.jpg,RBC,452,1,556,95,1,104,94,504,48,0.7875,0.1,0.1625,0.19583333333333333
BloodImage_00127.jpg,111.jpg,RBC,109,272,210,357,1,101,85,159,314,0.2484375,0.6541666666666667,0.1578125,0.17708333333333334
BloodImage_00127.jpg,111.jpg,RBC,251,1,352,86,1,101,85,301,43,0.4703125,0.08958333333333333,0.1578125,0.17708333333333334
BloodImage_00127.jpg,111.jpg,RBC,218,389,323,480,1,105,91,270,434,0.421875,0.9041666666666667,0.1640625,0.18958333333333333
BloodImage_00127.jpg,111.jpg,WBC,172,126,349,312,2,177,186,260,219,0.40625,0.45625,0.2765625,0.3875
BloodImage_00127.jpg,111.jpg,Platelets,546,82,584,118,0,38,36,565,100,0.8828125,0.20833333333333334,0.059375,0.075
BloodImage_00130.jpg,112.jpg,RBC,470,282,551,370,1,81,88,510,326,0.796875,0.6791666666666667,0.1265625,0.18333333333333332
BloodImage_00130.jpg,112.jpg,RBC,479,342,566,429,1,87,87,522,385,0.815625,0.8020833333333334,0.1359375,0.18125
BloodImage_00130.jpg,112.jpg,RBC,566,322,640,424,1,74,102,603,373,0.9421875,0.7770833333333333,0.115625,0.2125
BloodImage_00130.jpg,112.jpg,RBC,301,329,412,443,1,111,114,356,386,0.55625,0.8041666666666667,0.1734375,0.2375
BloodImage_00130.jpg,112.jpg,RBC,254,231,335,323,1,81,92,294,277,0.459375,0.5770833333333333,0.1265625,0.19166666666666668
BloodImage_00130.jpg,112.jpg,RBC,30,313,134,426,1,104,113,82,369,0.128125,0.76875,0.1625,0.23541666666666666
BloodImage_00130.jpg,112.jpg,RBC,155,94,236,208,1,81,114,195,151,0.3046875,0.3145833333333333,0.1265625,0.2375
BloodImage_00130.jpg,112.jpg,RBC,203,310,311,440,1,108,130,257,375,0.4015625,0.78125,0.16875,0.2708333333333333
BloodImage_00130.jpg,112.jpg,WBC,238,53,414,210,2,176,157,326,131,0.509375,0.27291666666666664,0.275,0.32708333333333334
BloodImage_00132.jpg,113.jpg,RBC,177,154,302,272,1,125,118,239,213,0.3734375,0.44375,0.1953125,0.24583333333333332
BloodImage_00132.jpg,113.jpg,RBC,221,271,346,389,1,125,118,283,330,0.4421875,0.6875,0.1953125,0.24583333333333332
BloodImage_00132.jpg,113.jpg,RBC,255,40,373,152,1,118,112,314,96,0.490625,0.2,0.184375,0.23333333333333334
BloodImage_00132.jpg,113.jpg,RBC,379,22,496,133,1,117,111,437,77,0.6828125,0.16041666666666668,0.1828125,0.23125
BloodImage_00132.jpg,113.jpg,RBC,78,382,188,480,1,110,98,133,431,0.2078125,0.8979166666666667,0.171875,0.20416666666666666
BloodImage_00132.jpg,113.jpg,RBC,20,8,154,113,1,134,105,87,60,0.1359375,0.125,0.209375,0.21875
BloodImage_00132.jpg,113.jpg,RBC,137,34,280,158,1,143,124,208,96,0.325,0.2,0.2234375,0.25833333333333336
BloodImage_00132.jpg,113.jpg,WBC,46,212,193,370,2,147,158,119,291,0.1859375,0.60625,0.2296875,0.32916666666666666
BloodImage_00132.jpg,113.jpg,Platelets,445,455,489,479,0,44,24,467,467,0.7296875,0.9729166666666667,0.06875,0.05
BloodImage_00133.jpg,114.jpg,RBC,471,11,592,130,1,121,119,531,70,0.8296875,0.14583333333333334,0.1890625,0.24791666666666667
BloodImage_00133.jpg,114.jpg,RBC,552,200,640,318,1,88,118,596,259,0.93125,0.5395833333333333,0.1375,0.24583333333333332
BloodImage_00133.jpg,114.jpg,RBC,520,312,632,430,1,112,118,576,371,0.9,0.7729166666666667,0.175,0.24583333333333332
BloodImage_00133.jpg,114.jpg,RBC,58,260,171,375,1,113,115,114,317,0.178125,0.6604166666666667,0.1765625,0.23958333333333334
BloodImage_00133.jpg,114.jpg,RBC,336,158,443,256,1,107,98,389,207,0.6078125,0.43125,0.1671875,0.20416666666666666
BloodImage_00133.jpg,114.jpg,RBC,84,379,191,477,1,107,98,137,428,0.2140625,0.8916666666666667,0.1671875,0.20416666666666666
BloodImage_00133.jpg,114.jpg,RBC,227,320,341,429,1,114,109,284,374,0.44375,0.7791666666666667,0.178125,0.22708333333333333
BloodImage_00133.jpg,114.jpg,RBC,1,327,59,431,1,58,104,30,379,0.046875,0.7895833333333333,0.090625,0.21666666666666667
BloodImage_00133.jpg,114.jpg,RBC,376,310,453,407,1,77,97,414,358,0.646875,0.7458333333333333,0.1203125,0.20208333333333334
BloodImage_00133.jpg,114.jpg,Platelets,135,1,302,117,0,167,116,218,59,0.340625,0.12291666666666666,0.2609375,0.24166666666666667
BloodImage_00134.jpg,115.jpg,WBC,250,196,405,337,2,155,141,327,266,0.5109375,0.5541666666666667,0.2421875,0.29375
BloodImage_00134.jpg,115.jpg,Platelets,5,455,38,480,0,33,25,21,467,0.0328125,0.9729166666666667,0.0515625,0.052083333333333336
BloodImage_00134.jpg,115.jpg,Platelets,596,259,640,307,0,44,48,618,283,0.965625,0.5895833333333333,0.06875,0.1
BloodImage_00135.jpg,116.jpg,RBC,20,243,105,328,1,85,85,62,285,0.096875,0.59375,0.1328125,0.17708333333333334
BloodImage_00135.jpg,116.jpg,RBC,201,261,316,341,1,115,80,258,301,0.403125,0.6270833333333333,0.1796875,0.16666666666666666
BloodImage_00135.jpg,116.jpg,RBC,247,83,375,214,1,128,131,311,148,0.4859375,0.30833333333333335,0.2,0.27291666666666664
BloodImage_00135.jpg,116.jpg,RBC,341,314,429,415,1,88,101,385,364,0.6015625,0.7583333333333333,0.1375,0.21041666666666667
BloodImage_00135.jpg,116.jpg,RBC,83,100,180,193,1,97,93,131,146,0.2046875,0.30416666666666664,0.1515625,0.19375
BloodImage_00135.jpg,116.jpg,RBC,456,234,544,344,1,88,110,500,289,0.78125,0.6020833333333333,0.1375,0.22916666666666666
BloodImage_00135.jpg,116.jpg,RBC,460,1,548,71,1,88,70,504,36,0.7875,0.075,0.1375,0.14583333333333334
BloodImage_00135.jpg,116.jpg,RBC,95,195,222,316,1,127,121,158,255,0.246875,0.53125,0.1984375,0.2520833333333333
BloodImage_00135.jpg,116.jpg,Platelets,42,345,185,480,0,143,135,113,412,0.1765625,0.8583333333333333,0.2234375,0.28125
BloodImage_00135.jpg,116.jpg,Platelets,224,168,273,213,0,49,45,248,190,0.3875,0.3958333333333333,0.0765625,0.09375
BloodImage_00135.jpg,116.jpg,Platelets,345,198,396,239,0,51,41,370,218,0.578125,0.45416666666666666,0.0796875,0.08541666666666667
BloodImage_00135.jpg,116.jpg,Platelets,177,34,215,64,0,38,30,196,49,0.30625,0.10208333333333333,0.059375,0.0625
BloodImage_00135.jpg,116.jpg,RBC,391,319,479,420,1,88,101,435,369,0.6796875,0.76875,0.1375,0.21041666666666667
BloodImage_00135.jpg,116.jpg,RBC,141,104,241,212,1,100,108,191,158,0.2984375,0.32916666666666666,0.15625,0.225
BloodImage_00136.jpg,117.jpg,RBC,439,279,550,372,1,111,93,494,325,0.771875,0.6770833333333334,0.1734375,0.19375
BloodImage_00136.jpg,117.jpg,RBC,464,117,577,227,1,113,110,520,172,0.8125,0.35833333333333334,0.1765625,0.22916666666666666
BloodImage_00136.jpg,117.jpg,RBC,414,44,507,148,1,93,104,460,96,0.71875,0.2,0.1453125,0.21666666666666667
BloodImage_00136.jpg,117.jpg,RBC,321,213,430,337,1,109,124,375,275,0.5859375,0.5729166666666666,0.1703125,0.25833333333333336
BloodImage_00136.jpg,117.jpg,RBC,246,329,350,429,1,104,100,298,379,0.465625,0.7895833333333333,0.1625,0.20833333333333334
BloodImage_00136.jpg,117.jpg,RBC,345,357,473,465,1,128,108,409,411,0.6390625,0.85625,0.2,0.225
BloodImage_00136.jpg,117.jpg,RBC,200,395,316,480,1,116,85,258,437,0.403125,0.9104166666666667,0.18125,0.17708333333333334
BloodImage_00136.jpg,117.jpg,RBC,323,41,425,128,1,102,87,374,84,0.584375,0.175,0.159375,0.18125
BloodImage_00136.jpg,117.jpg,RBC,359,110,461,197,1,102,87,410,153,0.640625,0.31875,0.159375,0.18125
BloodImage_00136.jpg,117.jpg,WBC,106,115,279,273,2,173,158,192,194,0.3,0.4041666666666667,0.2703125,0.32916666666666666
BloodImage_00136.jpg,117.jpg,Platelets,550,441,592,480,0,42,39,571,460,0.8921875,0.9583333333333334,0.065625,0.08125
BloodImage_00136.jpg,117.jpg,Platelets,101,240,143,286,0,42,46,122,263,0.190625,0.5479166666666667,0.065625,0.09583333333333334
BloodImage_00137.jpg,118.jpg,RBC,146,333,273,459,1,127,126,209,396,0.3265625,0.825,0.1984375,0.2625
BloodImage_00137.jpg,118.jpg,RBC,211,247,316,360,1,105,113,263,303,0.4109375,0.63125,0.1640625,0.23541666666666666
BloodImage_00137.jpg,118.jpg,RBC,79,145,208,264,1,129,119,143,204,0.2234375,0.425,0.2015625,0.24791666666666667
BloodImage_00137.jpg,118.jpg,RBC,466,231,555,320,1,89,89,510,275,0.796875,0.5729166666666666,0.1390625,0.18541666666666667
BloodImage_00137.jpg,118.jpg,WBC,227,10,399,153,2,172,143,313,81,0.4890625,0.16875,0.26875,0.29791666666666666
BloodImage_00137.jpg,118.jpg,RBC,264,248,351,352,1,87,104,307,300,0.4796875,0.625,0.1359375,0.21666666666666667
BloodImage_00139.jpg,119.jpg,RBC,229,7,338,117,1,109,110,283,62,0.4421875,0.12916666666666668,0.1703125,0.22916666666666666
BloodImage_00139.jpg,119.jpg,RBC,258,225,368,333,1,110,108,313,279,0.4890625,0.58125,0.171875,0.225
BloodImage_00139.jpg,119.jpg,RBC,77,226,187,334,1,110,108,132,280,0.20625,0.5833333333333334,0.171875,0.225
BloodImage_00139.jpg,119.jpg,RBC,88,58,232,222,1,144,164,160,140,0.25,0.2916666666666667,0.225,0.3416666666666667
BloodImage_00139.jpg,119.jpg,RBC,469,303,598,420,1,129,117,533,361,0.8328125,0.7520833333333333,0.2015625,0.24375
BloodImage_00139.jpg,119.jpg,RBC,401,273,515,380,1,114,107,458,326,0.715625,0.6791666666666667,0.178125,0.22291666666666668
BloodImage_00139.jpg,119.jpg,RBC,159,314,269,422,1,110,108,214,368,0.334375,0.7666666666666667,0.171875,0.225
BloodImage_00139.jpg,119.jpg,RBC,478,228,592,335,1,114,107,535,281,0.8359375,0.5854166666666667,0.178125,0.22291666666666668
BloodImage_00139.jpg,119.jpg,RBC,11,312,121,420,1,110,108,66,366,0.103125,0.7625,0.171875,0.225
BloodImage_00139.jpg,119.jpg,WBC,269,353,440,480,2,171,127,354,416,0.553125,0.8666666666666667,0.2671875,0.26458333333333334
BloodImage_00139.jpg,119.jpg,Platelets,179,208,223,245,0,44,37,201,226,0.3140625,0.4708333333333333,0.06875,0.07708333333333334
BloodImage_00139.jpg,119.jpg,Platelets,115,1,157,34,0,42,33,136,17,0.2125,0.035416666666666666,0.065625,0.06875
BloodImage_00140.jpg,120.jpg,RBC,337,260,469,386,1,132,126,403,323,0.6296875,0.6729166666666667,0.20625,0.2625
BloodImage_00140.jpg,120.jpg,RBC,489,259,615,362,1,126,103,552,310,0.8625,0.6458333333333334,0.196875,0.21458333333333332
BloodImage_00140.jpg,120.jpg,RBC,65,343,219,476,1,154,133,142,409,0.221875,0.8520833333333333,0.240625,0.27708333333333335
BloodImage_00140.jpg,120.jpg,RBC,540,74,640,171,1,100,97,590,122,0.921875,0.25416666666666665,0.15625,0.20208333333333334
BloodImage_00140.jpg,120.jpg,RBC,48,216,153,315,1,105,99,100,265,0.15625,0.5520833333333334,0.1640625,0.20625
BloodImage_00140.jpg,120.jpg,RBC,405,329,550,423,1,145,94,477,376,0.7453125,0.7833333333333333,0.2265625,0.19583333333333333
BloodImage_00140.jpg,120.jpg,WBC,239,100,375,242,2,136,142,307,171,0.4796875,0.35625,0.2125,0.29583333333333334
BloodImage_00140.jpg,120.jpg,RBC,483,100,583,197,1,100,97,533,148,0.8328125,0.30833333333333335,0.15625,0.20208333333333334
BloodImage_00140.jpg,120.jpg,RBC,441,79,542,176,1,101,97,491,127,0.7671875,0.26458333333333334,0.1578125,0.20208333333333334
BloodImage_00141.jpg,121.jpg,RBC,539,53,640,154,1,101,101,589,103,0.9203125,0.21458333333333332,0.1578125,0.21041666666666667
BloodImage_00141.jpg,121.jpg,RBC,393,334,511,437,1,118,103,452,385,0.70625,0.8020833333333334,0.184375,0.21458333333333332
BloodImage_00141.jpg,121.jpg,RBC,501,278,618,406,1,117,128,559,342,0.8734375,0.7125,0.1828125,0.26666666666666666
BloodImage_00141.jpg,121.jpg,RBC,423,1,543,115,1,120,114,483,58,0.7546875,0.12083333333333333,0.1875,0.2375
BloodImage_00141.jpg,121.jpg,RBC,331,76,442,168,1,111,92,386,122,0.603125,0.25416666666666665,0.1734375,0.19166666666666668
BloodImage_00141.jpg,121.jpg,RBC,312,176,439,302,1,127,126,375,239,0.5859375,0.4979166666666667,0.1984375,0.2625
BloodImage_00141.jpg,121.jpg,RBC,10,196,117,292,1,107,96,63,244,0.0984375,0.5083333333333333,0.1671875,0.2
BloodImage_00141.jpg,121.jpg,RBC,113,153,231,271,1,118,118,172,212,0.26875,0.44166666666666665,0.184375,0.24583333333333332
BloodImage_00141.jpg,121.jpg,RBC,249,133,364,229,1,115,96,306,181,0.478125,0.3770833333333333,0.1796875,0.2
BloodImage_00141.jpg,121.jpg,WBC,57,278,345,480,2,288,202,201,379,0.3140625,0.7895833333333333,0.45,0.42083333333333334
BloodImage_00142.jpg,122.jpg,RBC,335,54,466,163,1,131,109,400,108,0.625,0.225,0.2046875,0.22708333333333333
BloodImage_00142.jpg,122.jpg,RBC,403,170,517,274,1,114,104,460,222,0.71875,0.4625,0.178125,0.21666666666666667
BloodImage_00142.jpg,122.jpg,RBC,485,201,598,284,1,113,83,541,242,0.8453125,0.5041666666666667,0.1765625,0.17291666666666666
BloodImage_00142.jpg,122.jpg,RBC,348,372,441,480,1,93,108,394,426,0.615625,0.8875,0.1453125,0.225
BloodImage_00142.jpg,122.jpg,RBC,18,276,111,384,1,93,108,64,330,0.1,0.6875,0.1453125,0.225
BloodImage_00142.jpg,122.jpg,RBC,101,12,206,117,1,105,105,153,64,0.2390625,0.13333333333333333,0.1640625,0.21875
BloodImage_00142.jpg,122.jpg,Platelets,1,113,27,149,0,26,36,14,131,0.021875,0.27291666666666664,0.040625,0.075
BloodImage_00142.jpg,122.jpg,WBC,211,172,389,324,2,178,152,300,248,0.46875,0.5166666666666667,0.278125,0.31666666666666665
BloodImage_00142.jpg,122.jpg,Platelets,569,422,606,455,0,37,33,587,438,0.9171875,0.9125,0.0578125,0.06875
BloodImage_00143.jpg,123.jpg,RBC,344,274,448,392,1,104,118,396,333,0.61875,0.69375,0.1625,0.24583333333333332
BloodImage_00143.jpg,123.jpg,RBC,416,371,572,461,1,156,90,494,416,0.771875,0.8666666666666667,0.24375,0.1875
BloodImage_00143.jpg,123.jpg,RBC,417,176,504,277,1,87,101,460,226,0.71875,0.4708333333333333,0.1359375,0.21041666666666667
BloodImage_00143.jpg,123.jpg,RBC,472,175,581,275,1,109,100,526,225,0.821875,0.46875,0.1703125,0.20833333333333334
BloodImage_00143.jpg,123.jpg,RBC,340,38,444,156,1,104,118,392,97,0.6125,0.20208333333333334,0.1625,0.24583333333333332
BloodImage_00143.jpg,123.jpg,WBC,40,41,222,206,2,182,165,131,123,0.2046875,0.25625,0.284375,0.34375
BloodImage_00143.jpg,123.jpg,Platelets,266,191,317,228,0,51,37,291,209,0.4546875,0.4354166666666667,0.0796875,0.07708333333333334
BloodImage_00144.jpg,124.jpg,RBC,86,1,208,101,1,122,100,147,51,0.2296875,0.10625,0.190625,0.20833333333333334
BloodImage_00144.jpg,124.jpg,RBC,116,66,242,195,1,126,129,179,130,0.2796875,0.2708333333333333,0.196875,0.26875
BloodImage_00144.jpg,124.jpg,RBC,185,1,310,76,1,125,75,247,38,0.3859375,0.07916666666666666,0.1953125,0.15625
BloodImage_00144.jpg,124.jpg,RBC,508,94,606,190,1,98,96,557,142,0.8703125,0.29583333333333334,0.153125,0.2
BloodImage_00144.jpg,124.jpg,RBC,2,285,80,387,1,78,102,41,336,0.0640625,0.7,0.121875,0.2125
BloodImage_00144.jpg,124.jpg,RBC,566,337,640,422,1,74,85,603,379,0.9421875,0.7895833333333333,0.115625,0.17708333333333334
BloodImage_00144.jpg,124.jpg,WBC,421,218,589,371,2,168,153,505,294,0.7890625,0.6125,0.2625,0.31875
BloodImage_00144.jpg,124.jpg,RBC,216,200,315,296,1,99,96,265,248,0.4140625,0.5166666666666667,0.1546875,0.2
BloodImage_00144.jpg,124.jpg,RBC,242,194,341,290,1,99,96,291,242,0.4546875,0.5041666666666667,0.1546875,0.2
BloodImage_00144.jpg,124.jpg,RBC,289,195,388,291,1,99,96,338,243,0.528125,0.50625,0.1546875,0.2
BloodImage_00145.jpg,125.jpg,RBC,239,265,342,357,1,103,92,290,311,0.453125,0.6479166666666667,0.1609375,0.19166666666666668
BloodImage_00145.jpg,125.jpg,RBC,168,1,271,92,1,103,91,219,46,0.3421875,0.09583333333333334,0.1609375,0.18958333333333333
BloodImage_00145.jpg,125.jpg,RBC,375,102,479,211,1,104,109,427,156,0.6671875,0.325,0.1625,0.22708333333333333
BloodImage_00145.jpg,125.jpg,RBC,498,114,621,236,1,123,122,559,175,0.8734375,0.3645833333333333,0.1921875,0.25416666666666665
BloodImage_00145.jpg,125.jpg,RBC,197,92,309,193,1,112,101,253,142,0.3953125,0.29583333333333334,0.175,0.21041666666666667
BloodImage_00145.jpg,125.jpg,RBC,3,76,112,175,1,109,99,57,125,0.0890625,0.2604166666666667,0.1703125,0.20625
BloodImage_00145.jpg,125.jpg,RBC,356,210,457,324,1,101,114,406,267,0.634375,0.55625,0.1578125,0.2375
BloodImage_00145.jpg,125.jpg,RBC,78,163,192,287,1,114,124,135,225,0.2109375,0.46875,0.178125,0.25833333333333336
BloodImage_00145.jpg,125.jpg,RBC,468,317,583,435,1,115,118,525,376,0.8203125,0.7833333333333333,0.1796875,0.24583333333333332
BloodImage_00145.jpg,125.jpg,RBC,106,388,209,480,1,103,92,157,434,0.2453125,0.9041666666666667,0.1609375,0.19166666666666668
BloodImage_00145.jpg,125.jpg,Platelets,146,325,200,368,0,54,43,173,346,0.2703125,0.7208333333333333,0.084375,0.08958333333333333
BloodImage_00145.jpg,125.jpg,Platelets,217,247,260,290,0,43,43,238,268,0.371875,0.5583333333333333,0.0671875,0.08958333333333333
BloodImage_00145.jpg,125.jpg,Platelets,340,300,385,346,0,45,46,362,323,0.565625,0.6729166666666667,0.0703125,0.09583333333333334
BloodImage_00145.jpg,125.jpg,WBC,300,353,459,480,2,159,127,379,416,0.5921875,0.8666666666666667,0.2484375,0.26458333333333334
BloodImage_00147.jpg,126.jpg,Platelets,200,249,238,294,0,38,45,219,271,0.3421875,0.5645833333333333,0.059375,0.09375
BloodImage_00147.jpg,126.jpg,WBC,339,42,514,207,2,175,165,426,124,0.665625,0.25833333333333336,0.2734375,0.34375
BloodImage_00148.jpg,127.jpg,RBC,404,253,511,356,1,107,103,457,304,0.7140625,0.6333333333333333,0.1671875,0.21458333333333332
BloodImage_00148.jpg,127.jpg,RBC,278,300,385,403,1,107,103,331,351,0.5171875,0.73125,0.1671875,0.21458333333333332
BloodImage_00148.jpg,127.jpg,RBC,501,170,608,273,1,107,103,554,221,0.865625,0.46041666666666664,0.1671875,0.21458333333333332
BloodImage_00148.jpg,127.jpg,RBC,86,1,193,124,1,107,123,139,62,0.2171875,0.12916666666666668,0.1671875,0.25625
BloodImage_00148.jpg,127.jpg,WBC,255,187,406,321,2,151,134,330,254,0.515625,0.5291666666666667,0.2359375,0.2791666666666667
BloodImage_00148.jpg,127.jpg,Platelets,507,265,566,334,0,59,69,536,299,0.8375,0.6229166666666667,0.0921875,0.14375
BloodImage_00149.jpg,128.jpg,RBC,328,181,430,281,1,102,100,379,231,0.5921875,0.48125,0.159375,0.20833333333333334
BloodImage_00149.jpg,128.jpg,RBC,15,1,130,96,1,115,95,72,48,0.1125,0.1,0.1796875,0.19791666666666666
BloodImage_00149.jpg,128.jpg,RBC,435,154,549,266,1,114,112,492,210,0.76875,0.4375,0.178125,0.23333333333333334
BloodImage_00149.jpg,128.jpg,RBC,104,240,218,338,1,114,98,161,289,0.2515625,0.6020833333333333,0.178125,0.20416666666666666
BloodImage_00149.jpg,128.jpg,RBC,524,363,638,460,1,114,97,581,411,0.9078125,0.85625,0.178125,0.20208333333333334
BloodImage_00149.jpg,128.jpg,RBC,513,20,627,117,1,114,97,570,68,0.890625,0.14166666666666666,0.178125,0.20208333333333334
BloodImage_00149.jpg,128.jpg,RBC,228,51,343,160,1,115,109,285,105,0.4453125,0.21875,0.1796875,0.22708333333333333
BloodImage_00149.jpg,128.jpg,RBC,373,69,464,149,1,91,80,418,109,0.653125,0.22708333333333333,0.1421875,0.16666666666666666
BloodImage_00149.jpg,128.jpg,Platelets,407,396,446,428,0,39,32,426,412,0.665625,0.8583333333333333,0.0609375,0.06666666666666667
BloodImage_00149.jpg,128.jpg,WBC,58,55,207,206,2,149,151,132,130,0.20625,0.2708333333333333,0.2328125,0.3145833333333333
BloodImage_00150.jpg,129.jpg,WBC,278,11,405,149,2,127,138,341,80,0.5328125,0.16666666666666666,0.1984375,0.2875
BloodImage_00150.jpg,129.jpg,Platelets,392,36,416,60,0,24,24,404,48,0.63125,0.1,0.0375,0.05
BloodImage_00152.jpg,130.jpg,WBC,128,31,281,172,2,153,141,204,101,0.31875,0.21041666666666667,0.2390625,0.29375
BloodImage_00154.jpg,131.jpg,RBC,208,278,312,400,1,104,122,260,339,0.40625,0.70625,0.1625,0.25416666666666665
BloodImage_00154.jpg,131.jpg,RBC,247,232,351,337,1,104,105,299,284,0.4671875,0.5916666666666667,0.1625,0.21875
BloodImage_00154.jpg,131.jpg,RBC,325,163,429,268,1,104,105,377,215,0.5890625,0.4479166666666667,0.1625,0.21875
BloodImage_00154.jpg,131.jpg,RBC,257,105,361,210,1,104,105,309,157,0.4828125,0.32708333333333334,0.1625,0.21875
BloodImage_00154.jpg,131.jpg,RBC,100,393,247,480,1,147,87,173,436,0.2703125,0.9083333333333333,0.2296875,0.18125
BloodImage_00154.jpg,131.jpg,RBC,1,60,104,165,1,103,105,52,112,0.08125,0.23333333333333334,0.1609375,0.21875
BloodImage_00154.jpg,131.jpg,WBC,354,4,513,153,2,159,149,433,78,0.6765625,0.1625,0.2484375,0.3104166666666667
BloodImage_00154.jpg,131.jpg,Platelets,230,146,267,177,0,37,31,248,161,0.3875,0.33541666666666664,0.0578125,0.06458333333333334
BloodImage_00156.jpg,132.jpg,RBC,169,326,296,405,1,127,79,232,365,0.3625,0.7604166666666666,0.1984375,0.16458333333333333
BloodImage_00156.jpg,132.jpg,RBC,216,187,341,296,1,125,109,278,241,0.434375,0.5020833333333333,0.1953125,0.22708333333333333
BloodImage_00156.jpg,132.jpg,RBC,93,128,179,208,1,86,80,136,168,0.2125,0.35,0.134375,0.16666666666666666
BloodImage_00156.jpg,132.jpg,RBC,105,245,195,362,1,90,117,150,303,0.234375,0.63125,0.140625,0.24375
BloodImage_00156.jpg,132.jpg,RBC,5,162,108,259,1,103,97,56,210,0.0875,0.4375,0.1609375,0.20208333333333334
BloodImage_00156.jpg,132.jpg,RBC,3,252,118,343,1,115,91,60,297,0.09375,0.61875,0.1796875,0.18958333333333333
BloodImage_00156.jpg,132.jpg,RBC,299,225,414,316,1,115,91,356,270,0.55625,0.5625,0.1796875,0.18958333333333333
BloodImage_00156.jpg,132.jpg,RBC,374,229,498,328,1,124,99,436,278,0.68125,0.5791666666666667,0.19375,0.20625
BloodImage_00156.jpg,132.jpg,RBC,160,415,280,480,1,120,65,220,447,0.34375,0.93125,0.1875,0.13541666666666666
BloodImage_00156.jpg,132.jpg,Platelets,451,400,486,434,0,35,34,468,417,0.73125,0.86875,0.0546875,0.07083333333333333
BloodImage_00156.jpg,132.jpg,Platelets,381,440,432,474,0,51,34,406,457,0.634375,0.9520833333333333,0.0796875,0.07083333333333333
BloodImage_00156.jpg,132.jpg,Platelets,534,370,586,426,0,52,56,560,398,0.875,0.8291666666666667,0.08125,0.11666666666666667
BloodImage_00156.jpg,132.jpg,Platelets,463,428,515,474,0,52,46,489,451,0.7640625,0.9395833333333333,0.08125,0.09583333333333334
BloodImage_00156.jpg,132.jpg,Platelets,409,59,460,96,0,51,37,434,77,0.678125,0.16041666666666668,0.0796875,0.07708333333333334
BloodImage_00156.jpg,132.jpg,Platelets,71,76,102,104,0,31,28,86,90,0.134375,0.1875,0.0484375,0.058333333333333334
BloodImage_00156.jpg,132.jpg,WBC,6,331,137,480,2,131,149,71,405,0.1109375,0.84375,0.2046875,0.3104166666666667
BloodImage_00157.jpg,133.jpg,RBC,108,147,217,248,1,109,101,162,197,0.253125,0.41041666666666665,0.1703125,0.21041666666666667
BloodImage_00157.jpg,133.jpg,RBC,523,128,632,229,1,109,101,577,178,0.9015625,0.37083333333333335,0.1703125,0.21041666666666667
BloodImage_00157.jpg,133.jpg,RBC,365,355,495,456,1,130,101,430,405,0.671875,0.84375,0.203125,0.21041666666666667
BloodImage_00157.jpg,133.jpg,WBC,202,183,377,345,2,175,162,289,264,0.4515625,0.55,0.2734375,0.3375
BloodImage_00158.jpg,134.jpg,RBC,237,344,325,436,1,88,92,281,390,0.4390625,0.8125,0.1375,0.19166666666666668
BloodImage_00158.jpg,134.jpg,RBC,148,177,236,269,1,88,92,192,223,0.3,0.46458333333333335,0.1375,0.19166666666666668
BloodImage_00158.jpg,134.jpg,RBC,475,343,597,465,1,122,122,536,404,0.8375,0.8416666666666667,0.190625,0.25416666666666665
BloodImage_00158.jpg,134.jpg,RBC,267,221,354,325,1,87,104,310,273,0.484375,0.56875,0.1359375,0.21666666666666667
BloodImage_00158.jpg,134.jpg,RBC,42,63,136,152,1,94,89,89,107,0.1390625,0.22291666666666668,0.146875,0.18541666666666667
BloodImage_00158.jpg,134.jpg,WBC,339,219,500,364,2,161,145,419,291,0.6546875,0.60625,0.2515625,0.3020833333333333
BloodImage_00158.jpg,134.jpg,Platelets,250,80,283,117,0,33,37,266,98,0.415625,0.20416666666666666,0.0515625,0.07708333333333334
BloodImage_00159.jpg,135.jpg,RBC,239,6,331,103,1,92,97,285,54,0.4453125,0.1125,0.14375,0.20208333333333334
BloodImage_00159.jpg,135.jpg,RBC,487,20,620,137,1,133,117,553,78,0.8640625,0.1625,0.2078125,0.24375
BloodImage_00159.jpg,135.jpg,RBC,418,171,524,282,1,106,111,471,226,0.7359375,0.4708333333333333,0.165625,0.23125
BloodImage_00159.jpg,135.jpg,RBC,487,253,598,363,1,111,110,542,308,0.846875,0.6416666666666667,0.1734375,0.22916666666666666
BloodImage_00159.jpg,135.jpg,RBC,274,382,384,480,1,110,98,329,431,0.5140625,0.8979166666666667,0.171875,0.20416666666666666
BloodImage_00159.jpg,135.jpg,Platelets,192,36,236,79,0,44,43,214,57,0.334375,0.11875,0.06875,0.08958333333333333
BloodImage_00159.jpg,135.jpg,Platelets,149,78,191,117,0,42,39,170,97,0.265625,0.20208333333333334,0.065625,0.08125
BloodImage_00159.jpg,135.jpg,Platelets,544,213,600,267,0,56,54,572,240,0.89375,0.5,0.0875,0.1125
BloodImage_00159.jpg,135.jpg,WBC,168,122,338,287,2,170,165,253,204,0.3953125,0.425,0.265625,0.34375
BloodImage_00160.jpg,136.jpg,RBC,170,185,280,287,1,110,102,225,236,0.3515625,0.49166666666666664,0.171875,0.2125
BloodImage_00160.jpg,136.jpg,RBC,402,215,512,317,1,110,102,457,266,0.7140625,0.5541666666666667,0.171875,0.2125
BloodImage_00160.jpg,136.jpg,RBC,501,303,611,405,1,110,102,556,354,0.86875,0.7375,0.171875,0.2125
BloodImage_00160.jpg,136.jpg,RBC,492,63,602,165,1,110,102,547,114,0.8546875,0.2375,0.171875,0.2125
BloodImage_00160.jpg,136.jpg,RBC,1,31,111,136,1,110,105,56,83,0.0875,0.17291666666666666,0.171875,0.21875
BloodImage_00160.jpg,136.jpg,RBC,148,297,270,400,1,122,103,209,348,0.3265625,0.725,0.190625,0.21458333333333332
BloodImage_00160.jpg,136.jpg,RBC,263,78,385,181,1,122,103,324,129,0.50625,0.26875,0.190625,0.21458333333333332
BloodImage_00160.jpg,136.jpg,RBC,426,147,529,233,1,103,86,477,190,0.7453125,0.3958333333333333,0.1609375,0.17916666666666667
BloodImage_00160.jpg,136.jpg,RBC,140,1,243,86,1,103,85,191,43,0.2984375,0.08958333333333333,0.1609375,0.17708333333333334
BloodImage_00160.jpg,136.jpg,Platelets,66,144,111,188,0,45,44,88,166,0.1375,0.3458333333333333,0.0703125,0.09166666666666666
BloodImage_00160.jpg,136.jpg,WBC,260,292,484,480,2,224,188,372,386,0.58125,0.8041666666666667,0.35,0.39166666666666666
BloodImage_00161.jpg,137.jpg,RBC,148,160,234,247,1,86,87,191,203,0.2984375,0.42291666666666666,0.134375,0.18125
BloodImage_00161.jpg,137.jpg,RBC,110,145,216,228,1,106,83,163,186,0.2546875,0.3875,0.165625,0.17291666666666666
BloodImage_00161.jpg,137.jpg,RBC,81,232,194,337,1,113,105,137,284,0.2140625,0.5916666666666667,0.1765625,0.21875
BloodImage_00161.jpg,137.jpg,RBC,456,146,565,261,1,109,115,510,203,0.796875,0.42291666666666666,0.1703125,0.23958333333333334
BloodImage_00161.jpg,137.jpg,RBC,254,344,363,459,1,109,115,308,401,0.48125,0.8354166666666667,0.1703125,0.23958333333333334
BloodImage_00161.jpg,137.jpg,RBC,407,178,516,293,1,109,115,461,235,0.7203125,0.4895833333333333,0.1703125,0.23958333333333334
BloodImage_00161.jpg,137.jpg,RBC,305,310,413,405,1,108,95,359,357,0.5609375,0.74375,0.16875,0.19791666666666666
BloodImage_00161.jpg,137.jpg,RBC,522,1,639,86,1,117,85,580,43,0.90625,0.08958333333333333,0.1828125,0.17708333333333334
BloodImage_00161.jpg,137.jpg,RBC,492,261,600,376,1,108,115,546,318,0.853125,0.6625,0.16875,0.23958333333333334
BloodImage_00161.jpg,137.jpg,RBC,387,266,506,402,1,119,136,446,334,0.696875,0.6958333333333333,0.1859375,0.2833333333333333
BloodImage_00161.jpg,137.jpg,RBC,135,338,245,439,1,110,101,190,388,0.296875,0.8083333333333333,0.171875,0.21041666666666667
BloodImage_00161.jpg,137.jpg,RBC,61,341,171,442,1,110,101,116,391,0.18125,0.8145833333333333,0.171875,0.21041666666666667
BloodImage_00161.jpg,137.jpg,RBC,1,88,59,181,1,58,93,30,134,0.046875,0.2791666666666667,0.090625,0.19375
BloodImage_00161.jpg,137.jpg,WBC,191,25,396,221,2,205,196,293,123,0.4578125,0.25625,0.3203125,0.4083333333333333
BloodImage_00162.jpg,138.jpg,RBC,67,167,165,268,1,98,101,116,217,0.18125,0.45208333333333334,0.153125,0.21041666666666667
BloodImage_00162.jpg,138.jpg,RBC,186,63,284,164,1,98,101,235,113,0.3671875,0.23541666666666666,0.153125,0.21041666666666667
BloodImage_00162.jpg,138.jpg,RBC,99,98,194,174,1,95,76,146,136,0.228125,0.2833333333333333,0.1484375,0.15833333333333333
BloodImage_00162.jpg,138.jpg,RBC,162,197,272,305,1,110,108,217,251,0.3390625,0.5229166666666667,0.171875,0.225
BloodImage_00162.jpg,138.jpg,RBC,230,134,358,244,1,128,110,294,189,0.459375,0.39375,0.2,0.22916666666666666
BloodImage_00162.jpg,138.jpg,RBC,430,366,542,458,1,112,92,486,412,0.759375,0.8583333333333333,0.175,0.19166666666666668
BloodImage_00162.jpg,138.jpg,RBC,509,394,609,480,1,100,86,559,437,0.8734375,0.9104166666666667,0.15625,0.17916666666666667
BloodImage_00162.jpg,138.jpg,RBC,416,256,547,361,1,131,105,481,308,0.7515625,0.6416666666666667,0.2046875,0.21875
BloodImage_00162.jpg,138.jpg,RBC,495,126,596,231,1,101,105,545,178,0.8515625,0.37083333333333335,0.1578125,0.21875
BloodImage_00162.jpg,138.jpg,RBC,6,32,147,137,1,141,105,76,84,0.11875,0.175,0.2203125,0.21875
BloodImage_00162.jpg,138.jpg,RBC,351,160,452,279,1,101,119,401,219,0.6265625,0.45625,0.1578125,0.24791666666666667
BloodImage_00162.jpg,138.jpg,WBC,110,294,351,479,2,241,185,230,386,0.359375,0.8041666666666667,0.3765625,0.3854166666666667
BloodImage_00162.jpg,138.jpg,Platelets,163,57,196,89,0,33,32,179,73,0.2796875,0.15208333333333332,0.0515625,0.06666666666666667
BloodImage_00163.jpg,139.jpg,RBC,474,80,575,176,1,101,96,524,128,0.81875,0.26666666666666666,0.1578125,0.2
BloodImage_00163.jpg,139.jpg,RBC,405,78,506,174,1,101,96,455,126,0.7109375,0.2625,0.1578125,0.2
BloodImage_00163.jpg,139.jpg,RBC,453,227,550,348,1,97,121,501,287,0.7828125,0.5979166666666667,0.1515625,0.2520833333333333
BloodImage_00163.jpg,139.jpg,RBC,64,89,161,210,1,97,121,112,149,0.175,0.3104166666666667,0.1515625,0.2520833333333333
BloodImage_00163.jpg,139.jpg,RBC,1,330,87,434,1,86,104,44,382,0.06875,0.7958333333333333,0.134375,0.21666666666666667
BloodImage_00163.jpg,139.jpg,RBC,277,301,389,394,1,112,93,333,347,0.5203125,0.7229166666666667,0.175,0.19375
BloodImage_00163.jpg,139.jpg,WBC,279,128,437,301,2,158,173,358,214,0.559375,0.44583333333333336,0.246875,0.36041666666666666
BloodImage_00163.jpg,139.jpg,Platelets,604,125,640,177,0,36,52,622,151,0.971875,0.3145833333333333,0.05625,0.10833333333333334
BloodImage_00164.jpg,140.jpg,RBC,169,179,300,317,1,131,138,234,248,0.365625,0.5166666666666667,0.2046875,0.2875
BloodImage_00164.jpg,140.jpg,RBC,423,336,520,453,1,97,117,471,394,0.7359375,0.8208333333333333,0.1515625,0.24375
BloodImage_00164.jpg,140.jpg,RBC,532,358,629,475,1,97,117,580,416,0.90625,0.8666666666666667,0.1515625,0.24375
BloodImage_00164.jpg,140.jpg,RBC,353,39,448,135,1,95,96,400,87,0.625,0.18125,0.1484375,0.2
BloodImage_00164.jpg,140.jpg,RBC,345,124,451,245,1,106,121,398,184,0.621875,0.38333333333333336,0.165625,0.2520833333333333
BloodImage_00164.jpg,140.jpg,RBC,309,233,415,354,1,106,121,362,293,0.565625,0.6104166666666667,0.165625,0.2520833333333333
BloodImage_00164.jpg,140.jpg,RBC,532,151,639,268,1,107,117,585,209,0.9140625,0.4354166666666667,0.1671875,0.24375
BloodImage_00164.jpg,140.jpg,RBC,455,69,593,184,1,138,115,524,126,0.81875,0.2625,0.215625,0.23958333333333334
BloodImage_00164.jpg,140.jpg,RBC,4,188,136,316,1,132,128,70,252,0.109375,0.525,0.20625,0.26666666666666666
BloodImage_00164.jpg,140.jpg,RBC,102,77,220,196,1,118,119,161,136,0.2515625,0.2833333333333333,0.184375,0.24791666666666667
BloodImage_00164.jpg,140.jpg,WBC,124,300,335,480,2,211,180,229,390,0.3578125,0.8125,0.3296875,0.375
BloodImage_00164.jpg,140.jpg,Platelets,589,134,626,167,0,37,33,607,150,0.9484375,0.3125,0.0578125,0.06875
BloodImage_00165.jpg,141.jpg,RBC,388,157,478,262,1,90,105,433,209,0.6765625,0.4354166666666667,0.140625,0.21875
BloodImage_00165.jpg,141.jpg,RBC,266,385,373,480,1,107,95,319,432,0.4984375,0.9,0.1671875,0.19791666666666666
BloodImage_00165.jpg,141.jpg,RBC,359,363,466,458,1,107,95,412,410,0.64375,0.8541666666666666,0.1671875,0.19791666666666666
BloodImage_00165.jpg,141.jpg,RBC,306,274,428,380,1,122,106,367,327,0.5734375,0.68125,0.190625,0.22083333333333333
BloodImage_00165.jpg,141.jpg,RBC,56,296,178,402,1,122,106,117,349,0.1828125,0.7270833333333333,0.190625,0.22083333333333333
BloodImage_00165.jpg,141.jpg,RBC,104,176,200,279,1,96,103,152,227,0.2375,0.47291666666666665,0.15,0.21458333333333332
BloodImage_00165.jpg,141.jpg,RBC,386,4,514,122,1,128,118,450,63,0.703125,0.13125,0.2,0.24583333333333332
BloodImage_00165.jpg,141.jpg,RBC,449,389,541,480,1,92,91,495,434,0.7734375,0.9041666666666667,0.14375,0.18958333333333333
BloodImage_00165.jpg,141.jpg,RBC,425,252,513,364,1,88,112,469,308,0.7328125,0.6416666666666667,0.1375,0.23333333333333334
BloodImage_00165.jpg,141.jpg,RBC,230,1,331,72,1,101,71,280,36,0.4375,0.075,0.1578125,0.14791666666666667
BloodImage_00165.jpg,141.jpg,WBC,170,57,411,290,2,241,233,290,173,0.453125,0.36041666666666666,0.3765625,0.48541666666666666
BloodImage_00166.jpg,142.jpg,RBC,480,2,589,93,1,109,91,534,47,0.834375,0.09791666666666667,0.1703125,0.18958333333333333
BloodImage_00166.jpg,142.jpg,RBC,347,199,455,314,1,108,115,401,256,0.6265625,0.5333333333333333,0.16875,0.23958333333333334
BloodImage_00166.jpg,142.jpg,RBC,494,357,578,466,1,84,109,536,411,0.8375,0.85625,0.13125,0.22708333333333333
BloodImage_00166.jpg,142.jpg,RBC,549,81,633,190,1,84,109,591,135,0.9234375,0.28125,0.13125,0.22708333333333333
BloodImage_00166.jpg,142.jpg,RBC,383,353,491,468,1,108,115,437,410,0.6828125,0.8541666666666666,0.16875,0.23958333333333334
BloodImage_00166.jpg,142.jpg,RBC,347,1,453,96,1,106,95,400,48,0.625,0.1,0.165625,0.19791666666666666
BloodImage_00166.jpg,142.jpg,RBC,55,77,182,191,1,127,114,118,134,0.184375,0.2791666666666667,0.1984375,0.2375
BloodImage_00166.jpg,142.jpg,RBC,254,28,368,129,1,114,101,311,78,0.4859375,0.1625,0.178125,0.21041666666666667
BloodImage_00166.jpg,142.jpg,RBC,5,198,127,299,1,122,101,66,248,0.103125,0.5166666666666667,0.190625,0.21041666666666667
BloodImage_00166.jpg,142.jpg,RBC,403,165,512,285,1,109,120,457,225,0.7140625,0.46875,0.1703125,0.25
BloodImage_00166.jpg,142.jpg,RBC,408,264,505,367,1,97,103,456,315,0.7125,0.65625,0.1515625,0.21458333333333332
BloodImage_00166.jpg,142.jpg,WBC,1,332,225,479,2,224,147,113,405,0.1765625,0.84375,0.35,0.30625
BloodImage_00166.jpg,142.jpg,Platelets,509,182,555,223,0,46,41,532,202,0.83125,0.42083333333333334,0.071875,0.08541666666666667
BloodImage_00167.jpg,143.jpg,RBC,28,286,134,382,1,106,96,81,334,0.1265625,0.6958333333333333,0.165625,0.2
BloodImage_00167.jpg,143.jpg,RBC,82,201,181,296,1,99,95,131,248,0.2046875,0.5166666666666667,0.1546875,0.19791666666666666
BloodImage_00167.jpg,143.jpg,RBC,60,1,159,85,1,99,84,109,43,0.1703125,0.08958333333333333,0.1546875,0.175
BloodImage_00167.jpg,143.jpg,RBC,180,3,286,107,1,106,104,233,55,0.3640625,0.11458333333333333,0.165625,0.21666666666666667
BloodImage_00167.jpg,143.jpg,RBC,329,1,455,85,1,126,84,392,43,0.6125,0.08958333333333333,0.196875,0.175
BloodImage_00167.jpg,143.jpg,RBC,304,97,405,202,1,101,105,354,149,0.553125,0.3104166666666667,0.1578125,0.21875
BloodImage_00167.jpg,143.jpg,RBC,408,128,509,233,1,101,105,458,180,0.715625,0.375,0.1578125,0.21875
BloodImage_00167.jpg,143.jpg,RBC,468,266,582,349,1,114,83,525,307,0.8203125,0.6395833333333333,0.178125,0.17291666666666666
BloodImage_00167.jpg,143.jpg,RBC,158,374,272,480,1,114,106,215,427,0.3359375,0.8895833333333333,0.178125,0.22083333333333333
BloodImage_00167.jpg,143.jpg,RBC,507,79,621,185,1,114,106,564,132,0.88125,0.275,0.178125,0.22083333333333333
BloodImage_00167.jpg,143.jpg,RBC,469,29,583,135,1,114,106,526,82,0.821875,0.17083333333333334,0.178125,0.22083333333333333
BloodImage_00167.jpg,143.jpg,RBC,526,189,640,272,1,114,83,583,230,0.9109375,0.4791666666666667,0.178125,0.17291666666666666
BloodImage_00167.jpg,143.jpg,RBC,194,204,295,310,1,101,106,244,257,0.38125,0.5354166666666667,0.1578125,0.22083333333333333
BloodImage_00167.jpg,143.jpg,RBC,133,109,245,227,1,112,118,189,168,0.2953125,0.35,0.175,0.24583333333333332
BloodImage_00167.jpg,143.jpg,WBC,225,259,456,479,2,231,220,340,369,0.53125,0.76875,0.3609375,0.4583333333333333
BloodImage_00168.jpg,144.jpg,RBC,440,347,563,450,1,123,103,501,398,0.7828125,0.8291666666666667,0.1921875,0.21458333333333332
BloodImage_00168.jpg,144.jpg,RBC,274,179,388,258,1,114,79,331,218,0.5171875,0.45416666666666666,0.178125,0.16458333333333333
BloodImage_00168.jpg,144.jpg,RBC,340,261,441,366,1,101,105,390,313,0.609375,0.6520833333333333,0.1578125,0.21875
BloodImage_00168.jpg,144.jpg,RBC,364,103,480,210,1,116,107,422,156,0.659375,0.325,0.18125,0.22291666666666668
BloodImage_00168.jpg,144.jpg,RBC,378,1,493,91,1,115,90,435,46,0.6796875,0.09583333333333334,0.1796875,0.1875
BloodImage_00168.jpg,144.jpg,RBC,32,371,152,480,1,120,109,92,425,0.14375,0.8854166666666666,0.1875,0.22708333333333333
BloodImage_00168.jpg,144.jpg,RBC,6,276,106,370,1,100,94,56,323,0.0875,0.6729166666666667,0.15625,0.19583333333333333
BloodImage_00168.jpg,144.jpg,RBC,6,41,130,141,1,124,100,68,91,0.10625,0.18958333333333333,0.19375,0.20833333333333334
BloodImage_00168.jpg,144.jpg,RBC,98,1,207,72,1,109,71,152,36,0.2375,0.075,0.1703125,0.14791666666666667
BloodImage_00168.jpg,144.jpg,RBC,207,1,316,72,1,109,71,261,36,0.4078125,0.075,0.1703125,0.14791666666666667
BloodImage_00168.jpg,144.jpg,RBC,503,75,609,180,1,106,105,556,127,0.86875,0.26458333333333334,0.165625,0.21875
BloodImage_00168.jpg,144.jpg,RBC,318,301,424,406,1,106,105,371,353,0.5796875,0.7354166666666667,0.165625,0.21875
BloodImage_00168.jpg,144.jpg,RBC,171,345,273,430,1,102,85,222,387,0.346875,0.80625,0.159375,0.17708333333333334
BloodImage_00168.jpg,144.jpg,RBC,181,47,306,169,1,125,122,243,108,0.3796875,0.225,0.1953125,0.25416666666666665
BloodImage_00168.jpg,144.jpg,RBC,560,135,640,232,1,80,97,600,183,0.9375,0.38125,0.125,0.20208333333333334
BloodImage_00168.jpg,144.jpg,RBC,1,134,97,227,1,96,93,49,180,0.0765625,0.375,0.15,0.19375
BloodImage_00168.jpg,144.jpg,Platelets,277,392,332,440,0,55,48,304,416,0.475,0.8666666666666667,0.0859375,0.1
BloodImage_00168.jpg,144.jpg,Platelets,526,219,589,283,0,63,64,557,251,0.8703125,0.5229166666666667,0.0984375,0.13333333333333333
BloodImage_00168.jpg,144.jpg,WBC,55,149,265,347,2,210,198,160,248,0.25,0.5166666666666667,0.328125,0.4125
BloodImage_00169.jpg,145.jpg,RBC,76,319,180,422,1,104,103,128,370,0.2,0.7708333333333334,0.1625,0.21458333333333332
BloodImage_00169.jpg,145.jpg,RBC,137,259,246,369,1,109,110,191,314,0.2984375,0.6541666666666667,0.1703125,0.22916666666666666
BloodImage_00169.jpg,145.jpg,RBC,237,297,354,406,1,117,109,295,351,0.4609375,0.73125,0.1828125,0.22708333333333333
BloodImage_00169.jpg,145.jpg,RBC,236,383,353,480,1,117,97,294,431,0.459375,0.8979166666666667,0.1828125,0.20208333333333334
BloodImage_00169.jpg,145.jpg,RBC,361,341,480,452,1,119,111,420,396,0.65625,0.825,0.1859375,0.23125
BloodImage_00169.jpg,145.jpg,RBC,455,178,574,289,1,119,111,514,233,0.803125,0.48541666666666666,0.1859375,0.23125
BloodImage_00169.jpg,145.jpg,RBC,330,222,457,341,1,127,119,393,281,0.6140625,0.5854166666666667,0.1984375,0.24791666666666667
BloodImage_00169.jpg,145.jpg,RBC,25,182,136,285,1,111,103,80,233,0.125,0.48541666666666666,0.1734375,0.21458333333333332
BloodImage_00169.jpg,145.jpg,RBC,43,81,155,180,1,112,99,99,130,0.1546875,0.2708333333333333,0.175,0.20625
BloodImage_00169.jpg,145.jpg,RBC,71,1,179,82,1,108,81,125,41,0.1953125,0.08541666666666667,0.16875,0.16875
BloodImage_00169.jpg,145.jpg,RBC,415,96,507,187,1,92,91,461,141,0.7203125,0.29375,0.14375,0.18958333333333333
BloodImage_00169.jpg,145.jpg,RBC,477,87,569,178,1,92,91,523,132,0.8171875,0.275,0.14375,0.18958333333333333
BloodImage_00169.jpg,145.jpg,RBC,548,1,640,91,1,92,90,594,46,0.928125,0.09583333333333334,0.14375,0.1875
BloodImage_00169.jpg,145.jpg,RBC,453,1,546,87,1,93,86,499,44,0.7796875,0.09166666666666666,0.1453125,0.17916666666666667
BloodImage_00169.jpg,145.jpg,RBC,533,327,640,440,1,107,113,586,383,0.915625,0.7979166666666667,0.1671875,0.23541666666666666
BloodImage_00169.jpg,145.jpg,RBC,430,288,557,408,1,127,120,493,348,0.7703125,0.725,0.1984375,0.25
BloodImage_00169.jpg,145.jpg,WBC,143,11,400,196,2,257,185,271,103,0.4234375,0.21458333333333332,0.4015625,0.3854166666666667
BloodImage_00170.jpg,146.jpg,RBC,359,101,459,216,1,100,115,409,158,0.6390625,0.32916666666666666,0.15625,0.23958333333333334
BloodImage_00170.jpg,146.jpg,RBC,394,365,509,463,1,115,98,451,414,0.7046875,0.8625,0.1796875,0.20416666666666666
BloodImage_00170.jpg,146.jpg,RBC,425,172,545,288,1,120,116,485,230,0.7578125,0.4791666666666667,0.1875,0.24166666666666667
BloodImage_00170.jpg,146.jpg,RBC,459,290,575,372,1,116,82,517,331,0.8078125,0.6895833333333333,0.18125,0.17083333333333334
BloodImage_00170.jpg,146.jpg,RBC,57,390,154,480,1,97,90,105,435,0.1640625,0.90625,0.1515625,0.1875
BloodImage_00170.jpg,146.jpg,RBC,1,233,97,330,1,96,97,49,281,0.0765625,0.5854166666666667,0.15,0.20208333333333334
BloodImage_00170.jpg,146.jpg,RBC,1,127,97,224,1,96,97,49,175,0.0765625,0.3645833333333333,0.15,0.20208333333333334
BloodImage_00170.jpg,146.jpg,RBC,271,21,395,133,1,124,112,333,77,0.5203125,0.16041666666666668,0.19375,0.23333333333333334
BloodImage_00170.jpg,146.jpg,RBC,185,110,292,220,1,107,110,238,165,0.371875,0.34375,0.1671875,0.22916666666666666
BloodImage_00170.jpg,146.jpg,RBC,86,88,193,198,1,107,110,139,143,0.2171875,0.29791666666666666,0.1671875,0.22916666666666666
BloodImage_00170.jpg,146.jpg,RBC,112,33,219,143,1,107,110,165,88,0.2578125,0.18333333333333332,0.1671875,0.22916666666666666
BloodImage_00170.jpg,146.jpg,RBC,564,174,640,274,1,76,100,602,224,0.940625,0.4666666666666667,0.11875,0.20833333333333334
BloodImage_00170.jpg,146.jpg,RBC,99,212,194,308,1,95,96,146,260,0.228125,0.5416666666666666,0.1484375,0.2
BloodImage_00170.jpg,146.jpg,WBC,179,174,401,395,2,222,221,290,284,0.453125,0.5916666666666667,0.346875,0.46041666666666664
BloodImage_00171.jpg,147.jpg,RBC,16,195,119,303,1,103,108,67,249,0.1046875,0.51875,0.1609375,0.225
BloodImage_00171.jpg,147.jpg,RBC,75,300,203,412,1,128,112,139,356,0.2171875,0.7416666666666667,0.2,0.23333333333333334
BloodImage_00171.jpg,147.jpg,RBC,516,108,626,213,1,110,105,571,160,0.8921875,0.3333333333333333,0.171875,0.21875
BloodImage_00171.jpg,147.jpg,RBC,373,105,469,225,1,96,120,421,165,0.6578125,0.34375,0.15,0.25
BloodImage_00171.jpg,147.jpg,RBC,171,205,296,314,1,125,109,233,259,0.3640625,0.5395833333333333,0.1953125,0.22708333333333333
BloodImage_00171.jpg,147.jpg,RBC,383,310,479,430,1,96,120,431,370,0.6734375,0.7708333333333334,0.15,0.25
BloodImage_00171.jpg,147.jpg,RBC,279,312,378,442,1,99,130,328,377,0.5125,0.7854166666666667,0.1546875,0.2708333333333333
BloodImage_00171.jpg,147.jpg,RBC,447,1,552,91,1,105,90,499,46,0.7796875,0.09583333333333334,0.1640625,0.1875
BloodImage_00171.jpg,147.jpg,RBC,200,411,288,480,1,88,69,244,445,0.38125,0.9270833333333334,0.1375,0.14375
BloodImage_00171.jpg,147.jpg,RBC,355,1,454,84,1,99,83,404,42,0.63125,0.0875,0.1546875,0.17291666666666666
BloodImage_00171.jpg,147.jpg,RBC,8,1,123,65,1,115,64,65,33,0.1015625,0.06875,0.1796875,0.13333333333333333
BloodImage_00171.jpg,147.jpg,RBC,580,232,640,331,1,60,99,610,281,0.953125,0.5854166666666667,0.09375,0.20625
BloodImage_00171.jpg,147.jpg,RBC,1,383,83,480,1,82,97,42,431,0.065625,0.8979166666666667,0.128125,0.20208333333333334
BloodImage_00172.jpg,148.jpg,RBC,110,213,230,332,1,120,119,170,272,0.265625,0.5666666666666667,0.1875,0.24791666666666667
BloodImage_00172.jpg,148.jpg,RBC,230,227,344,335,1,114,108,287,281,0.4484375,0.5854166666666667,0.178125,0.225
BloodImage_00172.jpg,148.jpg,RBC,185,1,281,101,1,96,100,233,51,0.3640625,0.10625,0.15,0.20833333333333334
BloodImage_00172.jpg,148.jpg,RBC,55,95,180,212,1,125,117,117,153,0.1828125,0.31875,0.1953125,0.24375
BloodImage_00172.jpg,148.jpg,RBC,36,150,133,256,1,97,106,84,203,0.13125,0.42291666666666666,0.1515625,0.22083333333333333
BloodImage_00172.jpg,148.jpg,RBC,20,334,123,454,1,103,120,71,394,0.1109375,0.8208333333333333,0.1609375,0.25
BloodImage_00172.jpg,148.jpg,RBC,352,228,455,324,1,103,96,403,276,0.6296875,0.575,0.1609375,0.2
BloodImage_00172.jpg,148.jpg,RBC,457,187,574,300,1,117,113,515,243,0.8046875,0.50625,0.1828125,0.23541666666666666
BloodImage_00172.jpg,148.jpg,RBC,361,330,478,443,1,117,113,419,386,0.6546875,0.8041666666666667,0.1828125,0.23541666666666666
BloodImage_00172.jpg,148.jpg,RBC,128,355,245,468,1,117,113,186,411,0.290625,0.85625,0.1828125,0.23541666666666666
BloodImage_00172.jpg,148.jpg,RBC,566,274,640,386,1,74,112,603,330,0.9421875,0.6875,0.115625,0.23333333333333334
BloodImage_00172.jpg,148.jpg,RBC,445,253,565,352,1,120,99,505,302,0.7890625,0.6291666666666667,0.1875,0.20625
BloodImage_00172.jpg,148.jpg,RBC,309,327,428,417,1,119,90,368,372,0.575,0.775,0.1859375,0.1875
BloodImage_00172.jpg,148.jpg,RBC,415,1,534,90,1,119,89,474,45,0.740625,0.09375,0.1859375,0.18541666666666667
BloodImage_00172.jpg,148.jpg,WBC,258,34,467,245,2,209,211,362,139,0.565625,0.28958333333333336,0.3265625,0.4395833333333333
BloodImage_00174.jpg,149.jpg,RBC,455,106,562,209,1,107,103,508,157,0.79375,0.32708333333333334,0.1671875,0.21458333333333332
BloodImage_00174.jpg,149.jpg,RBC,490,249,597,352,1,107,103,543,300,0.8484375,0.625,0.1671875,0.21458333333333332
BloodImage_00174.jpg,149.jpg,RBC,543,165,640,269,1,97,104,591,217,0.9234375,0.45208333333333334,0.1515625,0.21666666666666667
BloodImage_00174.jpg,149.jpg,RBC,568,323,640,428,1,72,105,604,375,0.94375,0.78125,0.1125,0.21875
BloodImage_00174.jpg,149.jpg,RBC,310,365,427,471,1,117,106,368,418,0.575,0.8708333333333333,0.1828125,0.22083333333333333
BloodImage_00174.jpg,149.jpg,RBC,298,46,418,157,1,120,111,358,101,0.559375,0.21041666666666667,0.1875,0.23125
BloodImage_00174.jpg,149.jpg,RBC,203,24,301,141,1,98,117,252,82,0.39375,0.17083333333333334,0.153125,0.24375
BloodImage_00174.jpg,149.jpg,RBC,394,1,491,107,1,97,106,442,54,0.690625,0.1125,0.1515625,0.22083333333333333
BloodImage_00174.jpg,149.jpg,RBC,1,153,77,259,1,76,106,39,206,0.0609375,0.42916666666666664,0.11875,0.22083333333333333
BloodImage_00174.jpg,149.jpg,RBC,1,379,67,480,1,66,101,34,429,0.053125,0.89375,0.103125,0.21041666666666667
BloodImage_00174.jpg,149.jpg,RBC,1,1,91,75,1,90,74,46,38,0.071875,0.07916666666666666,0.140625,0.15416666666666667
BloodImage_00174.jpg,149.jpg,RBC,95,1,210,93,1,115,92,152,47,0.2375,0.09791666666666667,0.1796875,0.19166666666666668
BloodImage_00174.jpg,149.jpg,RBC,37,317,152,410,1,115,93,94,363,0.146875,0.75625,0.1796875,0.19375
BloodImage_00174.jpg,149.jpg,WBC,188,161,398,368,2,210,207,293,264,0.4578125,0.55,0.328125,0.43125
BloodImage_00174.jpg,149.jpg,Platelets,287,406,316,444,0,29,38,301,425,0.4703125,0.8854166666666666,0.0453125,0.07916666666666666
BloodImage_00175.jpg,150.jpg,RBC,19,2,129,114,1,110,112,74,58,0.115625,0.12083333333333333,0.171875,0.23333333333333334
BloodImage_00175.jpg,150.jpg,RBC,1,176,99,293,1,98,117,50,234,0.078125,0.4875,0.153125,0.24375
BloodImage_00175.jpg,150.jpg,RBC,187,56,283,152,1,96,96,235,104,0.3671875,0.21666666666666667,0.15,0.2
BloodImage_00175.jpg,150.jpg,RBC,298,182,418,275,1,120,93,358,228,0.559375,0.475,0.1875,0.19375
BloodImage_00175.jpg,150.jpg,RBC,396,249,516,342,1,120,93,456,295,0.7125,0.6145833333333334,0.1875,0.19375
BloodImage_00175.jpg,150.jpg,RBC,520,9,640,102,1,120,93,580,55,0.90625,0.11458333333333333,0.1875,0.19375
BloodImage_00175.jpg,150.jpg,RBC,29,305,149,398,1,120,93,89,351,0.1390625,0.73125,0.1875,0.19375
BloodImage_00175.jpg,150.jpg,RBC,520,107,640,221,1,120,114,580,164,0.90625,0.3416666666666667,0.1875,0.2375
BloodImage_00175.jpg,150.jpg,RBC,110,172,196,260,1,86,88,153,216,0.2390625,0.45,0.134375,0.18333333333333332
BloodImage_00175.jpg,150.jpg,WBC,211,248,422,479,2,211,231,316,363,0.49375,0.75625,0.3296875,0.48125
BloodImage_00176.jpg,151.jpg,RBC,242,222,347,325,1,105,103,294,273,0.459375,0.56875,0.1640625,0.21458333333333332
BloodImage_00176.jpg,151.jpg,RBC,464,43,556,137,1,92,94,510,90,0.796875,0.1875,0.14375,0.19583333333333333
BloodImage_00176.jpg,151.jpg,RBC,531,186,631,288,1,100,102,581,237,0.9078125,0.49375,0.15625,0.2125
BloodImage_00176.jpg,151.jpg,RBC,23,88,124,195,1,101,107,73,141,0.1140625,0.29375,0.1578125,0.22291666666666668
BloodImage_00176.jpg,151.jpg,RBC,377,234,478,341,1,101,107,427,287,0.6671875,0.5979166666666667,0.1578125,0.22291666666666668
BloodImage_00176.jpg,151.jpg,RBC,59,196,160,303,1,101,107,109,249,0.1703125,0.51875,0.1578125,0.22291666666666668
BloodImage_00176.jpg,151.jpg,RBC,289,1,393,86,1,104,85,341,43,0.5328125,0.08958333333333333,0.1625,0.17708333333333334
BloodImage_00176.jpg,151.jpg,RBC,152,274,256,360,1,104,86,204,317,0.31875,0.6604166666666667,0.1625,0.17916666666666667
BloodImage_00176.jpg,151.jpg,RBC,320,387,429,480,1,109,93,374,433,0.584375,0.9020833333333333,0.1703125,0.19375
BloodImage_00176.jpg,151.jpg,RBC,190,412,322,480,1,132,68,256,446,0.4,0.9291666666666667,0.20625,0.14166666666666666
BloodImage_00176.jpg,151.jpg,RBC,64,365,170,480,1,106,115,117,422,0.1828125,0.8791666666666667,0.165625,0.23958333333333334
BloodImage_00176.jpg,151.jpg,WBC,107,34,324,234,2,217,200,215,134,0.3359375,0.2791666666666667,0.3390625,0.4166666666666667
BloodImage_00176.jpg,151.jpg,WBC,306,102,460,246,2,154,144,383,174,0.5984375,0.3625,0.240625,0.3
BloodImage_00176.jpg,151.jpg,Platelets,604,385,637,417,0,33,32,620,401,0.96875,0.8354166666666667,0.0515625,0.06666666666666667
BloodImage_00177.jpg,152.jpg,RBC,375,115,498,215,1,123,100,436,165,0.68125,0.34375,0.1921875,0.20833333333333334
BloodImage_00177.jpg,152.jpg,RBC,279,264,399,392,1,120,128,339,328,0.5296875,0.6833333333333333,0.1875,0.26666666666666666
BloodImage_00177.jpg,152.jpg,RBC,447,189,560,307,1,113,118,503,248,0.7859375,0.5166666666666667,0.1765625,0.24583333333333332
BloodImage_00177.jpg,152.jpg,RBC,121,341,256,442,1,135,101,188,391,0.29375,0.8145833333333333,0.2109375,0.21041666666666667
BloodImage_00177.jpg,152.jpg,RBC,1,101,75,244,1,74,143,38,172,0.059375,0.35833333333333334,0.115625,0.29791666666666666
BloodImage_00177.jpg,152.jpg,RBC,323,6,453,122,1,130,116,388,64,0.60625,0.13333333333333333,0.203125,0.24166666666666667
BloodImage_00177.jpg,152.jpg,RBC,452,1,537,119,1,85,118,494,60,0.771875,0.125,0.1328125,0.24583333333333332
BloodImage_00177.jpg,152.jpg,RBC,542,259,640,383,1,98,124,591,321,0.9234375,0.66875,0.153125,0.25833333333333336
BloodImage_00177.jpg,152.jpg,RBC,550,124,640,233,1,90,109,595,178,0.9296875,0.37083333333333335,0.140625,0.22708333333333333
BloodImage_00177.jpg,152.jpg,RBC,553,1,640,85,1,87,84,596,43,0.93125,0.08958333333333333,0.1359375,0.175
BloodImage_00177.jpg,152.jpg,RBC,306,377,425,480,1,119,103,365,428,0.5703125,0.8916666666666667,0.1859375,0.21458333333333332
BloodImage_00177.jpg,152.jpg,Platelets,506,156,536,187,0,30,31,521,171,0.8140625,0.35625,0.046875,0.06458333333333334
BloodImage_00177.jpg,152.jpg,Platelets,385,217,438,264,0,53,47,411,240,0.6421875,0.5,0.0828125,0.09791666666666667
BloodImage_00177.jpg,152.jpg,WBC,176,92,372,268,2,196,176,274,180,0.428125,0.375,0.30625,0.36666666666666664
BloodImage_00178.jpg,153.jpg,RBC,26,293,124,386,1,98,93,75,339,0.1171875,0.70625,0.153125,0.19375
BloodImage_00178.jpg,153.jpg,RBC,293,345,416,449,1,123,104,354,397,0.553125,0.8270833333333333,0.1921875,0.21666666666666667
BloodImage_00178.jpg,153.jpg,RBC,519,189,640,315,1,121,126,579,252,0.9046875,0.525,0.1890625,0.2625
BloodImage_00178.jpg,153.jpg,RBC,480,27,601,153,1,121,126,540,90,0.84375,0.1875,0.1890625,0.2625
BloodImage_00178.jpg,153.jpg,RBC,402,1,510,78,1,108,77,456,39,0.7125,0.08125,0.16875,0.16041666666666668
BloodImage_00178.jpg,153.jpg,RBC,327,250,429,343,1,102,93,378,296,0.590625,0.6166666666666667,0.159375,0.19375
BloodImage_00178.jpg,153.jpg,RBC,414,275,549,377,1,135,102,481,326,0.7515625,0.6791666666666667,0.2109375,0.2125
BloodImage_00178.jpg,153.jpg,RBC,554,342,640,443,1,86,101,597,392,0.9328125,0.8166666666666667,0.134375,0.21041666666666667
BloodImage_00178.jpg,153.jpg,RBC,3,391,99,480,1,96,89,51,435,0.0796875,0.90625,0.15,0.18541666666666667
BloodImage_00178.jpg,153.jpg,RBC,72,19,174,130,1,102,111,123,74,0.1921875,0.15416666666666667,0.159375,0.23125
BloodImage_00178.jpg,153.jpg,RBC,144,189,273,305,1,129,116,208,247,0.325,0.5145833333333333,0.2015625,0.24166666666666667
BloodImage_00178.jpg,153.jpg,RBC,122,319,237,413,1,115,94,179,366,0.2796875,0.7625,0.1796875,0.19583333333333333
BloodImage_00179.jpg,154.jpg,RBC,65,42,165,177,1,100,135,115,109,0.1796875,0.22708333333333333,0.15625,0.28125
BloodImage_00179.jpg,154.jpg,RBC,373,1,488,83,1,115,82,430,42,0.671875,0.0875,0.1796875,0.17083333333333334
BloodImage_00179.jpg,154.jpg,RBC,227,3,346,107,1,119,104,286,55,0.446875,0.11458333333333333,0.1859375,0.21666666666666667
BloodImage_00179.jpg,154.jpg,RBC,487,128,606,232,1,119,104,546,180,0.853125,0.375,0.1859375,0.21666666666666667
BloodImage_00179.jpg,154.jpg,RBC,175,288,294,392,1,119,104,234,340,0.365625,0.7083333333333334,0.1859375,0.21666666666666667
BloodImage_00179.jpg,154.jpg,RBC,94,387,212,480,1,118,93,153,433,0.2390625,0.9020833333333333,0.184375,0.19375
BloodImage_00179.jpg,154.jpg,RBC,311,351,420,465,1,109,114,365,408,0.5703125,0.85,0.1703125,0.2375
BloodImage_00179.jpg,154.jpg,RBC,49,273,155,360,1,106,87,102,316,0.159375,0.6583333333333333,0.165625,0.18125
BloodImage_00179.jpg,154.jpg,RBC,165,77,273,185,1,108,108,219,131,0.3421875,0.27291666666666664,0.16875,0.225
BloodImage_00179.jpg,154.jpg,RBC,106,168,248,293,1,142,125,177,230,0.2765625,0.4791666666666667,0.221875,0.2604166666666667
BloodImage_00179.jpg,154.jpg,RBC,466,397,575,480,1,109,83,520,438,0.8125,0.9125,0.1703125,0.17291666666666666
BloodImage_00179.jpg,154.jpg,RBC,557,202,640,307,1,83,105,598,254,0.934375,0.5291666666666667,0.1296875,0.21875
BloodImage_00179.jpg,154.jpg,WBC,253,143,466,351,2,213,208,359,247,0.5609375,0.5145833333333333,0.3328125,0.43333333333333335
BloodImage_00179.jpg,154.jpg,Platelets,70,15,108,53,0,38,38,89,34,0.1390625,0.07083333333333333,0.059375,0.07916666666666666
BloodImage_00180.jpg,155.jpg,RBC,38,197,149,320,1,111,123,93,258,0.1453125,0.5375,0.1734375,0.25625
BloodImage_00180.jpg,155.jpg,RBC,31,73,143,174,1,112,101,87,123,0.1359375,0.25625,0.175,0.21041666666666667
BloodImage_00180.jpg,155.jpg,RBC,108,45,202,141,1,94,96,155,93,0.2421875,0.19375,0.146875,0.2
BloodImage_00180.jpg,155.jpg,RBC,378,136,472,232,1,94,96,425,184,0.6640625,0.38333333333333336,0.146875,0.2
BloodImage_00180.jpg,155.jpg,RBC,166,290,282,379,1,116,89,224,334,0.35,0.6958333333333333,0.18125,0.18541666666666667
BloodImage_00180.jpg,155.jpg,RBC,42,391,158,480,1,116,89,100,435,0.15625,0.90625,0.18125,0.18541666666666667
BloodImage_00180.jpg,155.jpg,RBC,524,62,640,158,1,116,96,582,110,0.909375,0.22916666666666666,0.18125,0.2
BloodImage_00180.jpg,155.jpg,RBC,243,203,373,319,1,130,116,308,261,0.48125,0.54375,0.203125,0.24166666666666667
BloodImage_00180.jpg,155.jpg,RBC,306,341,411,447,1,105,106,358,394,0.559375,0.8208333333333333,0.1640625,0.22083333333333333
BloodImage_00180.jpg,155.jpg,RBC,516,158,633,263,1,117,105,574,210,0.896875,0.4375,0.1828125,0.21875
BloodImage_00180.jpg,155.jpg,WBC,173,1,387,131,2,214,130,280,66,0.4375,0.1375,0.334375,0.2708333333333333
BloodImage_00182.jpg,156.jpg,RBC,161,75,286,185,1,125,110,223,130,0.3484375,0.2708333333333333,0.1953125,0.22916666666666666
BloodImage_00182.jpg,156.jpg,RBC,48,78,179,207,1,131,129,113,142,0.1765625,0.29583333333333334,0.2046875,0.26875
BloodImage_00182.jpg,156.jpg,RBC,516,183,637,296,1,121,113,576,239,0.9,0.4979166666666667,0.1890625,0.23541666666666666
BloodImage_00182.jpg,156.jpg,RBC,173,351,291,449,1,118,98,232,400,0.3625,0.8333333333333334,0.184375,0.20416666666666666
BloodImage_00182.jpg,156.jpg,RBC,47,361,165,459,1,118,98,106,410,0.165625,0.8541666666666666,0.184375,0.20416666666666666
BloodImage_00182.jpg,156.jpg,RBC,1,11,118,109,1,117,98,59,60,0.0921875,0.125,0.1828125,0.20416666666666666
BloodImage_00182.jpg,156.jpg,RBC,439,10,580,132,1,141,122,509,71,0.7953125,0.14791666666666667,0.2203125,0.25416666666666665
BloodImage_00182.jpg,156.jpg,RBC,315,242,436,344,1,121,102,375,293,0.5859375,0.6104166666666667,0.1890625,0.2125
BloodImage_00182.jpg,156.jpg,RBC,519,378,624,472,1,105,94,571,425,0.8921875,0.8854166666666666,0.1640625,0.19583333333333333
BloodImage_00182.jpg,156.jpg,WBC,293,57,498,260,2,205,203,395,158,0.6171875,0.32916666666666666,0.3203125,0.42291666666666666
BloodImage_00183.jpg,157.jpg,RBC,234,307,343,423,1,109,116,288,365,0.45,0.7604166666666666,0.1703125,0.24166666666666667
BloodImage_00183.jpg,157.jpg,RBC,415,219,550,359,1,135,140,482,289,0.753125,0.6020833333333333,0.2109375,0.2916666666666667
BloodImage_00183.jpg,157.jpg,RBC,69,126,178,242,1,109,116,123,184,0.1921875,0.38333333333333336,0.1703125,0.24166666666666667
BloodImage_00183.jpg,157.jpg,RBC,288,1,397,97,1,109,96,342,49,0.534375,0.10208333333333333,0.1703125,0.2
BloodImage_00183.jpg,157.jpg,RBC,572,330,640,434,1,68,104,606,382,0.946875,0.7958333333333333,0.10625,0.21666666666666667
BloodImage_00183.jpg,157.jpg,RBC,101,378,214,480,1,113,102,157,429,0.2453125,0.89375,0.1765625,0.2125
BloodImage_00183.jpg,157.jpg,RBC,58,8,156,108,1,98,100,107,58,0.1671875,0.12083333333333333,0.153125,0.20833333333333334
BloodImage_00183.jpg,157.jpg,WBC,251,91,471,306,2,220,215,361,198,0.5640625,0.4125,0.34375,0.4479166666666667
BloodImage_00183.jpg,157.jpg,Platelets,142,53,177,87,0,35,34,159,70,0.2484375,0.14583333333333334,0.0546875,0.07083333333333333
BloodImage_00183.jpg,157.jpg,Platelets,549,237,600,285,0,51,48,574,261,0.896875,0.54375,0.0796875,0.1
BloodImage_00184.jpg,158.jpg,RBC,323,70,433,173,1,110,103,378,121,0.590625,0.2520833333333333,0.171875,0.21458333333333332
BloodImage_00184.jpg,158.jpg,RBC,441,119,572,219,1,131,100,506,169,0.790625,0.35208333333333336,0.2046875,0.20833333333333334
BloodImage_00184.jpg,158.jpg,RBC,119,164,231,265,1,112,101,175,214,0.2734375,0.44583333333333336,0.175,0.21041666666666667
BloodImage_00184.jpg,158.jpg,RBC,1,263,89,361,1,88,98,45,312,0.0703125,0.65,0.1375,0.20416666666666666
BloodImage_00184.jpg,158.jpg,RBC,451,297,563,398,1,112,101,507,347,0.7921875,0.7229166666666667,0.175,0.21041666666666667
BloodImage_00184.jpg,158.jpg,RBC,308,327,420,428,1,112,101,364,377,0.56875,0.7854166666666667,0.175,0.21041666666666667
BloodImage_00184.jpg,158.jpg,RBC,65,315,165,414,1,100,99,115,364,0.1796875,0.7583333333333333,0.15625,0.20625
BloodImage_00184.jpg,158.jpg,RBC,490,1,590,99,1,100,98,540,50,0.84375,0.10416666666666667,0.15625,0.20416666666666666
BloodImage_00184.jpg,158.jpg,RBC,284,161,384,260,1,100,99,334,210,0.521875,0.4375,0.15625,0.20625
BloodImage_00184.jpg,158.jpg,WBC,93,1,296,173,2,203,172,194,87,0.303125,0.18125,0.3171875,0.35833333333333334
BloodImage_00187.jpg,159.jpg,Platelets,74,313,109,352,0,35,39,91,332,0.1421875,0.6916666666666667,0.0546875,0.08125
BloodImage_00187.jpg,159.jpg,WBC,159,229,403,468,2,244,239,281,348,0.4390625,0.725,0.38125,0.4979166666666667
BloodImage_00187.jpg,159.jpg,RBC,401,57,495,168,1,94,111,448,112,0.7,0.23333333333333334,0.146875,0.23125
BloodImage_00187.jpg,159.jpg,RBC,442,65,547,190,1,105,125,494,127,0.771875,0.26458333333333334,0.1640625,0.2604166666666667
BloodImage_00187.jpg,159.jpg,RBC,192,137,306,248,1,114,111,249,192,0.3890625,0.4,0.178125,0.23125
BloodImage_00187.jpg,159.jpg,RBC,22,46,136,157,1,114,111,79,101,0.1234375,0.21041666666666667,0.178125,0.23125
BloodImage_00187.jpg,159.jpg,RBC,134,48,248,159,1,114,111,191,103,0.2984375,0.21458333333333332,0.178125,0.23125
BloodImage_00187.jpg,159.jpg,RBC,459,267,565,366,1,106,99,512,316,0.8,0.6583333333333333,0.165625,0.20625
BloodImage_00189.jpg,160.jpg,RBC,385,66,502,191,1,117,125,443,128,0.6921875,0.26666666666666666,0.1828125,0.2604166666666667
BloodImage_00189.jpg,160.jpg,RBC,261,73,367,157,1,106,84,314,115,0.490625,0.23958333333333334,0.165625,0.175
BloodImage_00189.jpg,160.jpg,RBC,483,156,587,303,1,104,147,535,229,0.8359375,0.47708333333333336,0.1625,0.30625
BloodImage_00189.jpg,160.jpg,RBC,380,269,480,372,1,100,103,430,320,0.671875,0.6666666666666666,0.15625,0.21458333333333332
BloodImage_00189.jpg,160.jpg,RBC,80,1,192,81,1,112,80,136,41,0.2125,0.08541666666666667,0.175,0.16666666666666666
BloodImage_00189.jpg,160.jpg,RBC,447,410,522,480,1,75,70,484,445,0.75625,0.9270833333333334,0.1171875,0.14583333333333334
BloodImage_00189.jpg,160.jpg,RBC,203,350,334,456,1,131,106,268,403,0.41875,0.8395833333333333,0.2046875,0.22083333333333333
BloodImage_00189.jpg,160.jpg,RBC,318,338,406,433,1,88,95,362,385,0.565625,0.8020833333333334,0.1375,0.19791666666666666
BloodImage_00189.jpg,160.jpg,RBC,1,142,100,253,1,99,111,50,197,0.078125,0.41041666666666665,0.1546875,0.23125
BloodImage_00189.jpg,160.jpg,RBC,506,21,606,132,1,100,111,556,76,0.86875,0.15833333333333333,0.15625,0.23125
BloodImage_00189.jpg,160.jpg,RBC,566,392,640,480,1,74,88,603,436,0.9421875,0.9083333333333333,0.115625,0.18333333333333332
BloodImage_00189.jpg,160.jpg,WBC,188,165,387,340,2,199,175,287,252,0.4484375,0.525,0.3109375,0.3645833333333333
BloodImage_00189.jpg,160.jpg,RBC,100,198,206,282,1,106,84,153,240,0.2390625,0.5,0.165625,0.175
BloodImage_00189.jpg,160.jpg,RBC,139,304,265,413,1,126,109,202,358,0.315625,0.7458333333333333,0.196875,0.22708333333333333
BloodImage_00190.jpg,161.jpg,RBC,256,16,373,118,1,117,102,314,67,0.490625,0.13958333333333334,0.1828125,0.2125
BloodImage_00190.jpg,161.jpg,RBC,412,37,506,136,1,94,99,459,86,0.7171875,0.17916666666666667,0.146875,0.20625
BloodImage_00190.jpg,161.jpg,RBC,115,10,208,99,1,93,89,161,54,0.2515625,0.1125,0.1453125,0.18541666666666667
BloodImage_00190.jpg,161.jpg,RBC,515,144,632,285,1,117,141,573,214,0.8953125,0.44583333333333336,0.1828125,0.29375
BloodImage_00190.jpg,161.jpg,RBC,373,237,484,344,1,111,107,428,290,0.66875,0.6041666666666666,0.1734375,0.22291666666666668
BloodImage_00190.jpg,161.jpg,RBC,502,45,613,152,1,111,107,557,98,0.8703125,0.20416666666666666,0.1734375,0.22291666666666668
BloodImage_00190.jpg,161.jpg,RBC,45,94,144,198,1,99,104,94,146,0.146875,0.30416666666666664,0.1546875,0.21666666666666667
BloodImage_00190.jpg,161.jpg,RBC,465,315,576,422,1,111,107,520,368,0.8125,0.7666666666666667,0.1734375,0.22291666666666668
BloodImage_00190.jpg,161.jpg,RBC,161,302,272,409,1,111,107,216,355,0.3375,0.7395833333333334,0.1734375,0.22291666666666668
BloodImage_00190.jpg,161.jpg,RBC,322,331,433,438,1,111,107,377,384,0.5890625,0.8,0.1734375,0.22291666666666668
BloodImage_00190.jpg,161.jpg,RBC,114,392,236,480,1,122,88,175,436,0.2734375,0.9083333333333333,0.190625,0.18333333333333332
BloodImage_00190.jpg,161.jpg,RBC,482,414,603,480,1,121,66,542,447,0.846875,0.93125,0.1890625,0.1375
BloodImage_00190.jpg,161.jpg,WBC,181,115,396,326,2,215,211,288,220,0.45,0.4583333333333333,0.3359375,0.4395833333333333
BloodImage_00190.jpg,161.jpg,Platelets,480,208,526,252,0,46,44,503,230,0.7859375,0.4791666666666667,0.071875,0.09166666666666666
BloodImage_00191.jpg,162.jpg,RBC,353,1,462,101,1,109,100,407,51,0.6359375,0.10625,0.1703125,0.20833333333333334
BloodImage_00191.jpg,162.jpg,RBC,296,98,402,235,1,106,137,349,166,0.5453125,0.3458333333333333,0.165625,0.28541666666666665
BloodImage_00191.jpg,162.jpg,RBC,303,264,424,382,1,121,118,363,323,0.5671875,0.6729166666666667,0.1890625,0.24583333333333332
BloodImage_00191.jpg,162.jpg,RBC,49,62,171,195,1,122,133,110,128,0.171875,0.26666666666666666,0.190625,0.27708333333333335
BloodImage_00191.jpg,162.jpg,RBC,205,21,299,117,1,94,96,252,69,0.39375,0.14375,0.146875,0.2
BloodImage_00191.jpg,162.jpg,RBC,562,1,640,86,1,78,85,601,43,0.9390625,0.08958333333333333,0.121875,0.17708333333333334
BloodImage_00191.jpg,162.jpg,RBC,173,171,292,285,1,119,114,232,228,0.3625,0.475,0.1859375,0.2375
BloodImage_00191.jpg,162.jpg,RBC,540,269,640,360,1,100,91,590,314,0.921875,0.6541666666666667,0.15625,0.18958333333333333
BloodImage_00191.jpg,162.jpg,RBC,514,342,633,439,1,119,97,573,390,0.8953125,0.8125,0.1859375,0.20208333333333334
BloodImage_00191.jpg,162.jpg,RBC,304,384,383,480,1,79,96,343,432,0.5359375,0.9,0.1234375,0.2
BloodImage_00191.jpg,162.jpg,RBC,574,158,640,278,1,66,120,607,218,0.9484375,0.45416666666666666,0.103125,0.25
BloodImage_00191.jpg,162.jpg,RBC,1,337,69,455,1,68,118,35,396,0.0546875,0.825,0.10625,0.24583333333333332
BloodImage_00191.jpg,162.jpg,RBC,1,132,70,224,1,69,92,35,178,0.0546875,0.37083333333333335,0.1078125,0.19166666666666668
BloodImage_00191.jpg,162.jpg,RBC,256,11,350,107,1,94,96,303,59,0.4734375,0.12291666666666666,0.146875,0.2
BloodImage_00191.jpg,162.jpg,WBC,423,76,572,213,2,149,137,497,144,0.7765625,0.3,0.2328125,0.28541666666666665
BloodImage_00192.jpg,163.jpg,RBC,137,352,243,453,1,106,101,190,402,0.296875,0.8375,0.165625,0.21041666666666667
BloodImage_00192.jpg,163.jpg,RBC,217,214,319,331,1,102,117,268,272,0.41875,0.5666666666666667,0.159375,0.24375
BloodImage_00192.jpg,163.jpg,RBC,280,105,381,204,1,101,99,330,154,0.515625,0.32083333333333336,0.1578125,0.20625
BloodImage_00192.jpg,163.jpg,RBC,397,82,506,176,1,109,94,451,129,0.7046875,0.26875,0.1703125,0.19583333333333333
BloodImage_00192.jpg,163.jpg,RBC,484,2,603,114,1,119,112,543,58,0.8484375,0.12083333333333333,0.1859375,0.23333333333333334
BloodImage_00192.jpg,163.jpg,RBC,538,340,640,443,1,102,103,589,391,0.9203125,0.8145833333333333,0.159375,0.21458333333333332
BloodImage_00192.jpg,163.jpg,RBC,48,244,179,371,1,131,127,113,307,0.1765625,0.6395833333333333,0.2046875,0.26458333333333334
BloodImage_00192.jpg,163.jpg,RBC,1,178,116,296,1,115,118,58,237,0.090625,0.49375,0.1796875,0.24583333333333332
BloodImage_00192.jpg,163.jpg,RBC,398,335,512,445,1,114,110,455,390,0.7109375,0.8125,0.178125,0.22916666666666666
BloodImage_00192.jpg,163.jpg,RBC,297,21,411,131,1,114,110,354,76,0.553125,0.15833333333333333,0.178125,0.22916666666666666
BloodImage_00192.jpg,163.jpg,RBC,1,318,91,427,1,90,109,46,372,0.071875,0.775,0.140625,0.22708333333333333
BloodImage_00192.jpg,163.jpg,WBC,412,177,613,355,2,201,178,512,266,0.8,0.5541666666666667,0.3140625,0.37083333333333335
BloodImage_00192.jpg,163.jpg,Platelets,86,375,133,415,0,47,40,109,395,0.1703125,0.8229166666666666,0.0734375,0.08333333333333333
BloodImage_00193.jpg,164.jpg,RBC,159,300,258,399,1,99,99,208,349,0.325,0.7270833333333333,0.1546875,0.20625
BloodImage_00193.jpg,164.jpg,RBC,480,297,584,379,1,104,82,532,338,0.83125,0.7041666666666667,0.1625,0.17083333333333334
BloodImage_00193.jpg,164.jpg,RBC,130,183,238,286,1,108,103,184,234,0.2875,0.4875,0.16875,0.21458333333333332
BloodImage_00193.jpg,164.jpg,RBC,210,196,326,324,1,116,128,268,260,0.41875,0.5416666666666666,0.18125,0.26666666666666666
BloodImage_00193.jpg,164.jpg,RBC,376,305,489,403,1,113,98,432,354,0.675,0.7375,0.1765625,0.20416666666666666
BloodImage_00193.jpg,164.jpg,RBC,136,55,238,143,1,102,88,187,99,0.2921875,0.20625,0.159375,0.18333333333333332
BloodImage_00193.jpg,164.jpg,RBC,359,1,483,97,1,124,96,421,49,0.6578125,0.10208333333333333,0.19375,0.2
BloodImage_00193.jpg,164.jpg,WBC,360,124,571,317,2,211,193,465,220,0.7265625,0.4583333333333333,0.3296875,0.40208333333333335
BloodImage_00193.jpg,164.jpg,WBC,418,382,640,479,2,222,97,529,430,0.8265625,0.8958333333333334,0.346875,0.20208333333333334
BloodImage_00195.jpg,165.jpg,RBC,142,354,258,447,1,116,93,200,400,0.3125,0.8333333333333334,0.18125,0.19375
BloodImage_00195.jpg,165.jpg,RBC,27,373,138,463,1,111,90,82,418,0.128125,0.8708333333333333,0.1734375,0.1875
BloodImage_00195.jpg,165.jpg,RBC,208,90,324,183,1,116,93,266,136,0.415625,0.2833333333333333,0.18125,0.19375
BloodImage_00195.jpg,165.jpg,RBC,387,41,504,149,1,117,108,445,95,0.6953125,0.19791666666666666,0.1828125,0.225
BloodImage_00195.jpg,165.jpg,RBC,417,154,510,263,1,93,109,463,208,0.7234375,0.43333333333333335,0.1453125,0.22708333333333333
BloodImage_00195.jpg,165.jpg,RBC,553,228,640,355,1,87,127,596,291,0.93125,0.60625,0.1359375,0.26458333333333334
BloodImage_00195.jpg,165.jpg,RBC,140,194,238,296,1,98,102,189,245,0.2953125,0.5104166666666666,0.153125,0.2125
BloodImage_00195.jpg,165.jpg,RBC,239,284,337,386,1,98,102,288,335,0.45,0.6979166666666666,0.153125,0.2125
BloodImage_00195.jpg,165.jpg,RBC,53,305,153,395,1,100,90,103,350,0.1609375,0.7291666666666666,0.15625,0.1875
BloodImage_00195.jpg,165.jpg,RBC,273,20,386,140,1,113,120,329,80,0.5140625,0.16666666666666666,0.1765625,0.25
BloodImage_00195.jpg,165.jpg,WBC,337,269,469,402,2,132,133,403,335,0.6296875,0.6979166666666666,0.20625,0.27708333333333335
BloodImage_00195.jpg,165.jpg,Platelets,134,194,167,227,0,33,33,150,210,0.234375,0.4375,0.0515625,0.06875
BloodImage_00195.jpg,165.jpg,WBC,555,89,640,213,2,85,124,597,151,0.9328125,0.3145833333333333,0.1328125,0.25833333333333336
BloodImage_00196.jpg,166.jpg,RBC,503,39,617,148,1,114,109,560,93,0.875,0.19375,0.178125,0.22708333333333333
BloodImage_00196.jpg,166.jpg,RBC,319,56,433,165,1,114,109,376,110,0.5875,0.22916666666666666,0.178125,0.22708333333333333
BloodImage_00196.jpg,166.jpg,RBC,52,133,166,242,1,114,109,109,187,0.1703125,0.38958333333333334,0.178125,0.22708333333333333
BloodImage_00196.jpg,166.jpg,RBC,131,315,245,424,1,114,109,188,369,0.29375,0.76875,0.178125,0.22708333333333333
BloodImage_00196.jpg,166.jpg,RBC,201,188,315,297,1,114,109,258,242,0.403125,0.5041666666666667,0.178125,0.22708333333333333
BloodImage_00196.jpg,166.jpg,RBC,233,124,347,233,1,114,109,290,178,0.453125,0.37083333333333335,0.178125,0.22708333333333333
BloodImage_00196.jpg,166.jpg,RBC,128,45,229,153,1,101,108,178,99,0.278125,0.20625,0.1578125,0.225
BloodImage_00196.jpg,166.jpg,RBC,251,385,355,479,1,104,94,303,432,0.4734375,0.9,0.1625,0.19583333333333333
BloodImage_00196.jpg,166.jpg,RBC,460,140,564,234,1,104,94,512,187,0.8,0.38958333333333334,0.1625,0.19583333333333333
BloodImage_00196.jpg,166.jpg,RBC,543,158,640,267,1,97,109,591,212,0.9234375,0.44166666666666665,0.1515625,0.22708333333333333
BloodImage_00196.jpg,166.jpg,WBC,317,222,562,441,2,245,219,439,331,0.6859375,0.6895833333333333,0.3828125,0.45625
BloodImage_00197.jpg,167.jpg,RBC,12,317,110,411,1,98,94,61,364,0.0953125,0.7583333333333333,0.153125,0.19583333333333333
BloodImage_00197.jpg,167.jpg,RBC,1,191,70,323,1,69,132,35,257,0.0546875,0.5354166666666667,0.1078125,0.275
BloodImage_00197.jpg,167.jpg,RBC,305,123,430,236,1,125,113,367,179,0.5734375,0.3729166666666667,0.1953125,0.23541666666666666
BloodImage_00197.jpg,167.jpg,RBC,392,248,494,356,1,102,108,443,302,0.6921875,0.6291666666666667,0.159375,0.225
BloodImage_00197.jpg,167.jpg,RBC,172,292,272,409,1,100,117,222,350,0.346875,0.7291666666666666,0.15625,0.24375
BloodImage_00197.jpg,167.jpg,RBC,520,184,640,294,1,120,110,580,239,0.90625,0.4979166666666667,0.1875,0.22916666666666666
BloodImage_00197.jpg,167.jpg,RBC,314,1,419,86,1,105,85,366,43,0.571875,0.08958333333333333,0.1640625,0.17708333333333334
BloodImage_00197.jpg,167.jpg,RBC,75,84,208,182,1,133,98,141,133,0.2203125,0.27708333333333335,0.2078125,0.20416666666666666
BloodImage_00197.jpg,167.jpg,RBC,51,149,177,279,1,126,130,114,214,0.178125,0.44583333333333336,0.196875,0.2708333333333333
BloodImage_00197.jpg,167.jpg,RBC,276,311,402,412,1,126,101,339,361,0.5296875,0.7520833333333333,0.196875,0.21041666666666667
BloodImage_00197.jpg,167.jpg,RBC,170,1,294,77,1,124,76,232,39,0.3625,0.08125,0.19375,0.15833333333333333
BloodImage_00197.jpg,167.jpg,Platelets,205,418,244,463,0,39,45,224,440,0.35,0.9166666666666666,0.0609375,0.09375
BloodImage_00197.jpg,167.jpg,Platelets,271,62,309,103,0,38,41,290,82,0.453125,0.17083333333333334,0.059375,0.08541666666666667
BloodImage_00197.jpg,167.jpg,WBC,400,7,557,159,2,157,152,478,83,0.746875,0.17291666666666666,0.2453125,0.31666666666666665
BloodImage_00198.jpg,168.jpg,RBC,268,5,377,100,1,109,95,322,52,0.503125,0.10833333333333334,0.1703125,0.19791666666666666
BloodImage_00198.jpg,168.jpg,RBC,478,99,587,194,1,109,95,532,146,0.83125,0.30416666666666664,0.1703125,0.19791666666666666
BloodImage_00198.jpg,168.jpg,RBC,116,385,225,480,1,109,95,170,432,0.265625,0.9,0.1703125,0.19791666666666666
BloodImage_00198.jpg,168.jpg,RBC,309,116,439,226,1,130,110,374,171,0.584375,0.35625,0.203125,0.22916666666666666
BloodImage_00198.jpg,168.jpg,RBC,382,61,489,149,1,107,88,435,105,0.6796875,0.21875,0.1671875,0.18333333333333332
BloodImage_00198.jpg,168.jpg,RBC,354,1,467,88,1,113,87,410,44,0.640625,0.09166666666666666,0.1765625,0.18125
BloodImage_00198.jpg,168.jpg,RBC,176,76,285,171,1,109,95,230,123,0.359375,0.25625,0.1703125,0.19791666666666666
BloodImage_00198.jpg,168.jpg,RBC,164,127,267,239,1,103,112,215,183,0.3359375,0.38125,0.1609375,0.23333333333333334
BloodImage_00198.jpg,168.jpg,RBC,431,295,549,410,1,118,115,490,352,0.765625,0.7333333333333333,0.184375,0.23958333333333334
BloodImage_00198.jpg,168.jpg,RBC,415,410,524,480,1,109,70,469,445,0.7328125,0.9270833333333334,0.1703125,0.14583333333333334
BloodImage_00198.jpg,168.jpg,RBC,300,403,427,480,1,127,77,363,441,0.5671875,0.91875,0.1984375,0.16041666666666668
BloodImage_00198.jpg,168.jpg,RBC,568,168,640,269,1,72,101,604,218,0.94375,0.45416666666666666,0.1125,0.21041666666666667
BloodImage_00198.jpg,168.jpg,RBC,40,340,131,434,1,91,94,85,387,0.1328125,0.80625,0.1421875,0.19583333333333333
BloodImage_00198.jpg,168.jpg,RBC,62,151,165,285,1,103,134,113,218,0.1765625,0.45416666666666666,0.1609375,0.2791666666666667
BloodImage_00198.jpg,168.jpg,Platelets,261,394,295,434,0,34,40,278,414,0.434375,0.8625,0.053125,0.08333333333333333
BloodImage_00198.jpg,168.jpg,WBC,243,208,452,400,2,209,192,347,304,0.5421875,0.6333333333333333,0.3265625,0.4
BloodImage_00199.jpg,169.jpg,RBC,469,40,580,130,1,111,90,524,85,0.81875,0.17708333333333334,0.1734375,0.1875
BloodImage_00199.jpg,169.jpg,RBC,375,55,488,154,1,113,99,431,104,0.6734375,0.21666666666666667,0.1765625,0.20625
BloodImage_00199.jpg,169.jpg,RBC,299,223,412,322,1,113,99,355,272,0.5546875,0.5666666666666667,0.1765625,0.20625
BloodImage_00199.jpg,169.jpg,RBC,477,239,578,328,1,101,89,527,283,0.8234375,0.5895833333333333,0.1578125,0.18541666666666667
BloodImage_00199.jpg,169.jpg,RBC,549,150,640,268,1,91,118,594,209,0.928125,0.4354166666666667,0.1421875,0.24583333333333332
BloodImage_00199.jpg,169.jpg,RBC,405,165,519,281,1,114,116,462,223,0.721875,0.46458333333333335,0.178125,0.24166666666666667
BloodImage_00199.jpg,169.jpg,RBC,43,350,156,449,1,113,99,99,399,0.1546875,0.83125,0.1765625,0.20625
BloodImage_00199.jpg,169.jpg,RBC,85,1,192,96,1,107,95,138,48,0.215625,0.1,0.1671875,0.19791666666666666
BloodImage_00199.jpg,169.jpg,RBC,249,352,372,459,1,123,107,310,405,0.484375,0.84375,0.1921875,0.22291666666666668
BloodImage_00199.jpg,169.jpg,RBC,420,340,544,468,1,124,128,482,404,0.753125,0.8416666666666667,0.19375,0.26666666666666666
BloodImage_00199.jpg,169.jpg,WBC,73,63,304,283,2,231,220,188,173,0.29375,0.36041666666666666,0.3609375,0.4583333333333333
BloodImage_00199.jpg,169.jpg,Platelets,336,136,371,167,0,35,31,353,151,0.5515625,0.3145833333333333,0.0546875,0.06458333333333334
BloodImage_00200.jpg,170.jpg,RBC,115,1,237,97,1,122,96,176,49,0.275,0.10208333333333333,0.190625,0.2
BloodImage_00200.jpg,170.jpg,RBC,138,400,254,480,1,116,80,196,440,0.30625,0.9166666666666666,0.18125,0.16666666666666666
BloodImage_00200.jpg,170.jpg,RBC,547,242,640,347,1,93,105,593,294,0.9265625,0.6125,0.1453125,0.21875
BloodImage_00200.jpg,170.jpg,RBC,1,107,119,190,1,118,83,60,148,0.09375,0.30833333333333335,0.184375,0.17291666666666666
BloodImage_00200.jpg,170.jpg,RBC,183,134,305,231,1,122,97,244,182,0.38125,0.37916666666666665,0.190625,0.20208333333333334
BloodImage_00200.jpg,170.jpg,RBC,64,324,186,421,1,122,97,125,372,0.1953125,0.775,0.190625,0.20208333333333334
BloodImage_00200.jpg,170.jpg,RBC,248,307,362,410,1,114,103,305,358,0.4765625,0.7458333333333333,0.178125,0.21458333333333332
BloodImage_00200.jpg,170.jpg,RBC,494,22,613,140,1,119,118,553,81,0.8640625,0.16875,0.1859375,0.24583333333333332
BloodImage_00200.jpg,170.jpg,RBC,548,111,636,208,1,88,97,592,159,0.925,0.33125,0.1375,0.20208333333333334
BloodImage_00200.jpg,170.jpg,Platelets,263,89,299,126,0,36,37,281,107,0.4390625,0.22291666666666668,0.05625,0.07708333333333334
BloodImage_00200.jpg,170.jpg,WBC,345,264,553,446,2,208,182,449,355,0.7015625,0.7395833333333334,0.325,0.37916666666666665
BloodImage_00201.jpg,171.jpg,RBC,302,9,406,100,1,104,91,354,54,0.553125,0.1125,0.1625,0.18958333333333333
BloodImage_00201.jpg,171.jpg,RBC,13,213,131,337,1,118,124,72,275,0.1125,0.5729166666666666,0.184375,0.25833333333333336
BloodImage_00201.jpg,171.jpg,RBC,60,338,149,452,1,89,114,104,395,0.1625,0.8229166666666666,0.1390625,0.2375
BloodImage_00201.jpg,171.jpg,RBC,1,358,89,472,1,88,114,45,415,0.0703125,0.8645833333333334,0.1375,0.2375
BloodImage_00201.jpg,171.jpg,RBC,169,157,275,253,1,106,96,222,205,0.346875,0.4270833333333333,0.165625,0.2
BloodImage_00201.jpg,171.jpg,RBC,388,135,494,231,1,106,96,441,183,0.6890625,0.38125,0.165625,0.2
BloodImage_00201.jpg,171.jpg,RBC,501,313,604,416,1,103,103,552,364,0.8625,0.7583333333333333,0.1609375,0.21458333333333332
BloodImage_00201.jpg,171.jpg,RBC,250,204,347,298,1,97,94,298,251,0.465625,0.5229166666666667,0.1515625,0.19583333333333333
BloodImage_00201.jpg,171.jpg,RBC,59,25,155,128,1,96,103,107,76,0.1671875,0.15833333333333333,0.15,0.21458333333333332
BloodImage_00201.jpg,171.jpg,WBC,324,225,523,425,2,199,200,423,325,0.6609375,0.6770833333333334,0.3109375,0.4166666666666667
BloodImage_00201.jpg,171.jpg,Platelets,607,132,640,165,0,33,33,623,148,0.9734375,0.30833333333333335,0.0515625,0.06875
BloodImage_00201.jpg,171.jpg,Platelets,564,419,598,460,0,34,41,581,439,0.9078125,0.9145833333333333,0.053125,0.08541666666666667
BloodImage_00202.jpg,172.jpg,RBC,8,119,117,222,1,109,103,62,170,0.096875,0.3541666666666667,0.1703125,0.21458333333333332
BloodImage_00202.jpg,172.jpg,RBC,276,1,385,103,1,109,102,330,52,0.515625,0.10833333333333334,0.1703125,0.2125
BloodImage_00202.jpg,172.jpg,RBC,408,40,521,152,1,113,112,464,96,0.725,0.2,0.1765625,0.23333333333333334
BloodImage_00202.jpg,172.jpg,RBC,550,218,640,326,1,90,108,595,272,0.9296875,0.5666666666666667,0.140625,0.225
BloodImage_00202.jpg,172.jpg,RBC,441,234,540,332,1,99,98,490,283,0.765625,0.5895833333333333,0.1546875,0.20416666666666666
BloodImage_00202.jpg,172.jpg,RBC,261,161,369,266,1,108,105,315,213,0.4921875,0.44375,0.16875,0.21875
BloodImage_00202.jpg,172.jpg,RBC,264,238,371,360,1,107,122,317,299,0.4953125,0.6229166666666667,0.1671875,0.25416666666666665
BloodImage_00202.jpg,172.jpg,RBC,203,318,321,409,1,118,91,262,363,0.409375,0.75625,0.184375,0.18958333333333333
BloodImage_00202.jpg,172.jpg,RBC,286,375,405,480,1,119,105,345,427,0.5390625,0.8895833333333333,0.1859375,0.21875
BloodImage_00202.jpg,172.jpg,RBC,111,158,250,296,1,139,138,180,227,0.28125,0.47291666666666665,0.2171875,0.2875
BloodImage_00202.jpg,172.jpg,RBC,457,124,593,242,1,136,118,525,183,0.8203125,0.38125,0.2125,0.24583333333333332
BloodImage_00202.jpg,172.jpg,RBC,213,77,322,180,1,109,103,267,128,0.4171875,0.26666666666666666,0.1703125,0.21458333333333332
BloodImage_00202.jpg,172.jpg,WBC,389,341,604,480,2,215,139,496,410,0.775,0.8541666666666666,0.3359375,0.28958333333333336
BloodImage_00203.jpg,173.jpg,RBC,420,58,528,156,1,108,98,474,107,0.740625,0.22291666666666668,0.16875,0.20416666666666666
BloodImage_00203.jpg,173.jpg,RBC,463,121,571,219,1,108,98,517,170,0.8078125,0.3541666666666667,0.16875,0.20416666666666666
BloodImage_00203.jpg,173.jpg,RBC,266,1,377,71,1,111,70,321,36,0.5015625,0.075,0.1734375,0.14583333333333334
BloodImage_00203.jpg,173.jpg,RBC,292,43,403,114,1,111,71,347,78,0.5421875,0.1625,0.1734375,0.14791666666666667
BloodImage_00203.jpg,173.jpg,RBC,459,351,567,444,1,108,93,513,397,0.8015625,0.8270833333333333,0.16875,0.19375
BloodImage_00203.jpg,173.jpg,RBC,12,206,120,306,1,108,100,66,256,0.103125,0.5333333333333333,0.16875,0.20833333333333334
BloodImage_00203.jpg,173.jpg,RBC,130,75,238,175,1,108,100,184,125,0.2875,0.2604166666666667,0.16875,0.20833333333333334
BloodImage_00203.jpg,173.jpg,RBC,506,222,610,333,1,104,111,558,277,0.871875,0.5770833333333333,0.1625,0.23125
BloodImage_00203.jpg,173.jpg,RBC,1,11,107,147,1,106,136,54,79,0.084375,0.16458333333333333,0.165625,0.2833333333333333
BloodImage_00203.jpg,173.jpg,WBC,170,262,386,453,2,216,191,278,357,0.434375,0.74375,0.3375,0.39791666666666664
BloodImage_00203.jpg,173.jpg,Platelets,291,132,330,171,0,39,39,310,151,0.484375,0.3145833333333333,0.0609375,0.08125
BloodImage_00203.jpg,173.jpg,Platelets,390,181,429,220,0,39,39,409,200,0.6390625,0.4166666666666667,0.0609375,0.08125
BloodImage_00204.jpg,174.jpg,RBC,4,376,110,475,1,106,99,57,425,0.0890625,0.8854166666666666,0.165625,0.20625
BloodImage_00204.jpg,174.jpg,RBC,294,50,400,149,1,106,99,347,99,0.5421875,0.20625,0.165625,0.20625
BloodImage_00204.jpg,174.jpg,RBC,146,208,231,286,1,85,78,188,247,0.29375,0.5145833333333333,0.1328125,0.1625
BloodImage_00204.jpg,174.jpg,RBC,485,308,584,407,1,99,99,534,357,0.834375,0.74375,0.1546875,0.20625
BloodImage_00204.jpg,174.jpg,RBC,567,193,640,294,1,73,101,603,243,0.9421875,0.50625,0.1140625,0.21041666666666667
BloodImage_00204.jpg,174.jpg,RBC,429,65,528,164,1,99,99,478,114,0.746875,0.2375,0.1546875,0.20625
BloodImage_00204.jpg,174.jpg,RBC,524,15,623,106,1,99,91,573,60,0.8953125,0.125,0.1546875,0.18958333333333333
BloodImage_00204.jpg,174.jpg,RBC,337,1,441,96,1,104,95,389,48,0.6078125,0.1,0.1625,0.19791666666666666
BloodImage_00204.jpg,174.jpg,RBC,37,142,139,256,1,102,114,88,199,0.1375,0.41458333333333336,0.159375,0.2375
BloodImage_00204.jpg,174.jpg,RBC,61,38,192,176,1,131,138,126,107,0.196875,0.22291666666666668,0.2046875,0.2875
BloodImage_00204.jpg,174.jpg,RBC,136,395,216,476,1,80,81,176,435,0.275,0.90625,0.125,0.16875
BloodImage_00204.jpg,174.jpg,RBC,435,180,548,266,1,113,86,491,223,0.7671875,0.46458333333333335,0.1765625,0.17916666666666667
BloodImage_00204.jpg,174.jpg,RBC,435,426,527,477,1,92,51,481,451,0.7515625,0.9395833333333333,0.14375,0.10625
BloodImage_00204.jpg,174.jpg,RBC,598,60,640,152,1,42,92,619,106,0.9671875,0.22083333333333333,0.065625,0.19166666666666668
BloodImage_00204.jpg,174.jpg,WBC,253,255,439,430,2,186,175,346,342,0.540625,0.7125,0.290625,0.3645833333333333
BloodImage_00204.jpg,174.jpg,Platelets,266,54,304,83,0,38,29,285,68,0.4453125,0.14166666666666666,0.059375,0.06041666666666667
BloodImage_00204.jpg,174.jpg,Platelets,1,250,29,282,0,28,32,15,266,0.0234375,0.5541666666666667,0.04375,0.06666666666666667
BloodImage_00205.jpg,175.jpg,RBC,157,140,250,245,1,93,105,203,192,0.3171875,0.4,0.1453125,0.21875
BloodImage_00205.jpg,175.jpg,RBC,1,209,93,314,1,92,105,47,261,0.0734375,0.54375,0.14375,0.21875
BloodImage_00205.jpg,175.jpg,RBC,73,299,168,415,1,95,116,120,357,0.1875,0.74375,0.1484375,0.24166666666666667
BloodImage_00205.jpg,175.jpg,RBC,359,352,454,448,1,95,96,406,400,0.634375,0.8333333333333334,0.1484375,0.2
BloodImage_00205.jpg,175.jpg,RBC,379,133,473,247,1,94,114,426,190,0.665625,0.3958333333333333,0.146875,0.2375
BloodImage_00205.jpg,175.jpg,RBC,280,122,376,229,1,96,107,328,175,0.5125,0.3645833333333333,0.15,0.22291666666666668
BloodImage_00205.jpg,175.jpg,RBC,348,229,450,337,1,102,108,399,283,0.6234375,0.5895833333333333,0.159375,0.225
BloodImage_00205.jpg,175.jpg,RBC,416,234,518,342,1,102,108,467,288,0.7296875,0.6,0.159375,0.225
BloodImage_00205.jpg,175.jpg,RBC,447,365,549,473,1,102,108,498,419,0.778125,0.8729166666666667,0.159375,0.225
BloodImage_00205.jpg,175.jpg,RBC,316,1,416,64,1,100,63,366,32,0.571875,0.06666666666666667,0.15625,0.13125
BloodImage_00205.jpg,175.jpg,RBC,26,58,133,166,1,107,108,79,112,0.1234375,0.23333333333333334,0.1671875,0.225
BloodImage_00205.jpg,175.jpg,RBC,423,1,524,81,1,101,80,473,41,0.7390625,0.08541666666666667,0.1578125,0.16666666666666666
BloodImage_00205.jpg,175.jpg,RBC,498,1,600,66,1,102,65,549,33,0.8578125,0.06875,0.159375,0.13541666666666666
BloodImage_00205.jpg,175.jpg,WBC,150,238,337,426,2,187,188,243,332,0.3796875,0.6916666666666667,0.2921875,0.39166666666666666
BloodImage_00206.jpg,176.jpg,RBC,167,298,289,410,1,122,112,228,354,0.35625,0.7375,0.190625,0.23333333333333334
BloodImage_00206.jpg,176.jpg,RBC,1,295,104,398,1,103,103,52,346,0.08125,0.7208333333333333,0.1609375,0.21458333333333332
BloodImage_00206.jpg,176.jpg,RBC,443,49,547,152,1,104,103,495,100,0.7734375,0.20833333333333334,0.1625,0.21458333333333332
BloodImage_00206.jpg,176.jpg,RBC,395,71,499,174,1,104,103,447,122,0.6984375,0.25416666666666665,0.1625,0.21458333333333332
BloodImage_00206.jpg,176.jpg,RBC,337,110,451,239,1,114,129,394,174,0.615625,0.3625,0.178125,0.26875
BloodImage_00206.jpg,176.jpg,RBC,187,141,313,254,1,126,113,250,197,0.390625,0.41041666666666665,0.196875,0.23541666666666666
BloodImage_00206.jpg,176.jpg,RBC,93,1,198,95,1,105,94,145,48,0.2265625,0.1,0.1640625,0.19583333333333333
BloodImage_00206.jpg,176.jpg,RBC,186,52,299,154,1,113,102,242,103,0.378125,0.21458333333333332,0.1765625,0.2125
BloodImage_00206.jpg,176.jpg,RBC,313,1,421,85,1,108,84,367,43,0.5734375,0.08958333333333333,0.16875,0.175
BloodImage_00206.jpg,176.jpg,RBC,285,263,379,355,1,94,92,332,309,0.51875,0.64375,0.146875,0.19166666666666668
BloodImage_00206.jpg,176.jpg,RBC,291,326,391,417,1,100,91,341,371,0.5328125,0.7729166666666667,0.15625,0.18958333333333333
BloodImage_00206.jpg,176.jpg,RBC,291,376,391,467,1,100,91,341,421,0.5328125,0.8770833333333333,0.15625,0.18958333333333333
BloodImage_00206.jpg,176.jpg,RBC,409,388,509,479,1,100,91,459,433,0.7171875,0.9020833333333333,0.15625,0.18958333333333333
BloodImage_00206.jpg,176.jpg,RBC,74,296,179,409,1,105,113,126,352,0.196875,0.7333333333333333,0.1640625,0.23541666666666666
BloodImage_00206.jpg,176.jpg,WBC,482,268,640,453,2,158,185,561,360,0.8765625,0.75,0.246875,0.3854166666666667
BloodImage_00206.jpg,176.jpg,Platelets,453,292,491,329,0,38,37,472,310,0.7375,0.6458333333333334,0.059375,0.07708333333333334
BloodImage_00206.jpg,176.jpg,Platelets,247,7,280,50,0,33,43,263,28,0.4109375,0.058333333333333334,0.0515625,0.08958333333333333
BloodImage_00207.jpg,177.jpg,RBC,199,69,291,173,1,92,104,245,121,0.3828125,0.2520833333333333,0.14375,0.21666666666666667
BloodImage_00207.jpg,177.jpg,RBC,1,117,92,221,1,91,104,46,169,0.071875,0.35208333333333336,0.1421875,0.21666666666666667
BloodImage_00207.jpg,177.jpg,RBC,80,1,214,122,1,134,121,147,61,0.2296875,0.12708333333333333,0.209375,0.2520833333333333
BloodImage_00207.jpg,177.jpg,RBC,195,171,292,287,1,97,116,243,229,0.3796875,0.47708333333333336,0.1515625,0.24166666666666667
BloodImage_00207.jpg,177.jpg,RBC,205,404,304,479,1,99,75,254,441,0.396875,0.91875,0.1546875,0.15625
BloodImage_00207.jpg,177.jpg,RBC,101,324,226,437,1,125,113,163,380,0.2546875,0.7916666666666666,0.1953125,0.23541666666666666
BloodImage_00207.jpg,177.jpg,RBC,467,135,566,236,1,99,101,516,185,0.80625,0.3854166666666667,0.1546875,0.21041666666666667
BloodImage_00207.jpg,177.jpg,RBC,521,198,640,319,1,119,121,580,258,0.90625,0.5375,0.1859375,0.2520833333333333
BloodImage_00207.jpg,177.jpg,RBC,374,201,475,303,1,101,102,424,252,0.6625,0.525,0.1578125,0.2125
BloodImage_00207.jpg,177.jpg,RBC,306,378,429,480,1,123,102,367,429,0.5734375,0.89375,0.1921875,0.2125
BloodImage_00207.jpg,177.jpg,RBC,348,47,461,155,1,113,108,404,101,0.63125,0.21041666666666667,0.1765625,0.225
BloodImage_00207.jpg,177.jpg,Platelets,512,79,550,119,0,38,40,531,99,0.8296875,0.20625,0.059375,0.08333333333333333
BloodImage_00207.jpg,177.jpg,WBC,424,308,639,480,2,215,172,531,394,0.8296875,0.8208333333333333,0.3359375,0.35833333333333334
BloodImage_00208.jpg,178.jpg,RBC,96,279,198,377,1,102,98,147,328,0.2296875,0.6833333333333333,0.159375,0.20416666666666666
BloodImage_00208.jpg,178.jpg,RBC,143,1,254,108,1,111,107,198,54,0.309375,0.1125,0.1734375,0.22291666666666668
BloodImage_00208.jpg,178.jpg,RBC,241,1,352,84,1,111,83,296,42,0.4625,0.0875,0.1734375,0.17291666666666666
BloodImage_00208.jpg,178.jpg,RBC,372,1,486,77,1,114,76,429,39,0.6703125,0.08125,0.178125,0.15833333333333333
BloodImage_00208.jpg,178.jpg,RBC,15,163,110,248,1,95,85,62,205,0.096875,0.4270833333333333,0.1484375,0.17708333333333334
BloodImage_00208.jpg,178.jpg,RBC,362,298,461,398,1,99,100,411,348,0.6421875,0.725,0.1546875,0.20833333333333334
BloodImage_00208.jpg,178.jpg,RBC,266,320,365,420,1,99,100,315,370,0.4921875,0.7708333333333334,0.1546875,0.20833333333333334
BloodImage_00208.jpg,178.jpg,RBC,27,394,115,480,1,88,86,71,437,0.1109375,0.9104166666666667,0.1375,0.17916666666666667
BloodImage_00208.jpg,178.jpg,RBC,177,160,308,286,1,131,126,242,223,0.378125,0.46458333333333335,0.2046875,0.2625
BloodImage_00208.jpg,178.jpg,RBC,332,395,430,480,1,98,85,381,437,0.5953125,0.9104166666666667,0.153125,0.17708333333333334
BloodImage_00208.jpg,178.jpg,RBC,401,395,499,480,1,98,85,450,437,0.703125,0.9104166666666667,0.153125,0.17708333333333334
BloodImage_00208.jpg,178.jpg,RBC,436,225,534,310,1,98,85,485,267,0.7578125,0.55625,0.153125,0.17708333333333334
BloodImage_00208.jpg,178.jpg,RBC,492,1,628,70,1,136,69,560,35,0.875,0.07291666666666667,0.2125,0.14375
BloodImage_00208.jpg,178.jpg,WBC,244,79,475,247,2,231,168,359,163,0.5609375,0.33958333333333335,0.3609375,0.35
BloodImage_00208.jpg,178.jpg,Platelets,122,13,157,52,0,35,39,139,32,0.2171875,0.06666666666666667,0.0546875,0.08125
BloodImage_00209.jpg,179.jpg,RBC,141,99,236,203,1,95,104,188,151,0.29375,0.3145833333333333,0.1484375,0.21666666666666667
BloodImage_00209.jpg,179.jpg,RBC,84,3,181,101,1,97,98,132,52,0.20625,0.10833333333333334,0.1515625,0.20416666666666666
BloodImage_00209.jpg,179.jpg,RBC,251,1,345,93,1,94,92,298,47,0.465625,0.09791666666666667,0.146875,0.19166666666666668
BloodImage_00209.jpg,179.jpg,RBC,373,11,467,104,1,94,93,420,57,0.65625,0.11875,0.146875,0.19375
BloodImage_00209.jpg,179.jpg,RBC,551,110,634,194,1,83,84,592,152,0.925,0.31666666666666665,0.1296875,0.175
BloodImage_00209.jpg,179.jpg,RBC,528,313,633,408,1,105,95,580,360,0.90625,0.75,0.1640625,0.19791666666666666
BloodImage_00209.jpg,179.jpg,RBC,191,281,296,376,1,105,95,243,328,0.3796875,0.6833333333333333,0.1640625,0.19791666666666666
BloodImage_00209.jpg,179.jpg,RBC,55,372,160,467,1,105,95,107,419,0.1671875,0.8729166666666667,0.1640625,0.19791666666666666
BloodImage_00209.jpg,179.jpg,RBC,330,128,455,225,1,125,97,392,176,0.6125,0.36666666666666664,0.1953125,0.20208333333333334
BloodImage_00209.jpg,179.jpg,RBC,200,347,300,433,1,100,86,250,390,0.390625,0.8125,0.15625,0.17916666666666667
BloodImage_00209.jpg,179.jpg,RBC,121,192,241,320,1,120,128,181,256,0.2828125,0.5333333333333333,0.1875,0.26666666666666666
BloodImage_00209.jpg,179.jpg,WBC,285,225,474,407,2,189,182,379,316,0.5921875,0.6583333333333333,0.2953125,0.37916666666666665
BloodImage_00210.jpg,180.jpg,RBC,300,67,423,169,1,123,102,361,118,0.5640625,0.24583333333333332,0.1921875,0.2125
BloodImage_00210.jpg,180.jpg,RBC,466,85,589,187,1,123,102,527,136,0.8234375,0.2833333333333333,0.1921875,0.2125
BloodImage_00210.jpg,180.jpg,RBC,458,145,581,247,1,123,102,519,196,0.8109375,0.4083333333333333,0.1921875,0.2125
BloodImage_00210.jpg,180.jpg,RBC,414,260,536,345,1,122,85,475,302,0.7421875,0.6291666666666667,0.190625,0.17708333333333334
BloodImage_00210.jpg,180.jpg,RBC,188,193,284,298,1,96,105,236,245,0.36875,0.5104166666666666,0.15,0.21875
BloodImage_00210.jpg,180.jpg,RBC,88,236,184,341,1,96,105,136,288,0.2125,0.6,0.15,0.21875
BloodImage_00210.jpg,180.jpg,RBC,28,48,124,153,1,96,105,76,100,0.11875,0.20833333333333334,0.15,0.21875
BloodImage_00210.jpg,180.jpg,RBC,228,397,331,480,1,103,83,279,438,0.4359375,0.9125,0.1609375,0.17291666666666666
BloodImage_00210.jpg,180.jpg,RBC,201,102,303,193,1,102,91,252,147,0.39375,0.30625,0.159375,0.18958333333333333
BloodImage_00210.jpg,180.jpg,RBC,283,279,390,380,1,107,101,336,329,0.525,0.6854166666666667,0.1671875,0.21041666666666667
BloodImage_00210.jpg,180.jpg,RBC,559,330,640,444,1,81,114,599,387,0.9359375,0.80625,0.1265625,0.2375
BloodImage_00210.jpg,180.jpg,RBC,2,359,112,463,1,110,104,57,411,0.0890625,0.85625,0.171875,0.21666666666666667
BloodImage_00210.jpg,180.jpg,WBC,343,335,558,479,2,215,144,450,407,0.703125,0.8479166666666667,0.3359375,0.3
BloodImage_00211.jpg,181.jpg,RBC,86,283,187,385,1,101,102,136,334,0.2125,0.6958333333333333,0.1578125,0.2125
BloodImage_00211.jpg,181.jpg,RBC,43,180,144,282,1,101,102,93,231,0.1453125,0.48125,0.1578125,0.2125
BloodImage_00211.jpg,181.jpg,RBC,213,16,314,118,1,101,102,263,67,0.4109375,0.13958333333333334,0.1578125,0.2125
BloodImage_00211.jpg,181.jpg,RBC,84,42,185,144,1,101,102,134,93,0.209375,0.19375,0.1578125,0.2125
BloodImage_00211.jpg,181.jpg,RBC,541,138,640,253,1,99,115,590,195,0.921875,0.40625,0.1546875,0.23958333333333334
BloodImage_00211.jpg,181.jpg,RBC,541,337,640,452,1,99,115,590,394,0.921875,0.8208333333333333,0.1546875,0.23958333333333334
BloodImage_00211.jpg,181.jpg,RBC,452,18,551,133,1,99,115,501,75,0.7828125,0.15625,0.1546875,0.23958333333333334
BloodImage_00211.jpg,181.jpg,RBC,515,16,636,140,1,121,124,575,78,0.8984375,0.1625,0.1890625,0.25833333333333336
BloodImage_00211.jpg,181.jpg,RBC,184,175,282,270,1,98,95,233,222,0.3640625,0.4625,0.153125,0.19791666666666666
BloodImage_00211.jpg,181.jpg,RBC,210,266,308,361,1,98,95,259,313,0.4046875,0.6520833333333333,0.153125,0.19791666666666666
BloodImage_00211.jpg,181.jpg,RBC,429,333,534,436,1,105,103,481,384,0.7515625,0.8,0.1640625,0.21458333333333332
BloodImage_00211.jpg,181.jpg,RBC,265,114,344,223,1,79,109,304,168,0.475,0.35,0.1234375,0.22708333333333333
BloodImage_00211.jpg,181.jpg,WBC,279,202,403,308,2,124,106,341,255,0.5328125,0.53125,0.19375,0.22083333333333333
BloodImage_00212.jpg,182.jpg,RBC,226,141,338,240,1,112,99,282,190,0.440625,0.3958333333333333,0.175,0.20625
BloodImage_00212.jpg,182.jpg,RBC,183,40,319,156,1,136,116,251,98,0.3921875,0.20416666666666666,0.2125,0.24166666666666667
BloodImage_00212.jpg,182.jpg,RBC,327,143,439,247,1,112,104,383,195,0.5984375,0.40625,0.175,0.21666666666666667
BloodImage_00212.jpg,182.jpg,RBC,505,291,611,393,1,106,102,558,342,0.871875,0.7125,0.165625,0.2125
BloodImage_00212.jpg,182.jpg,RBC,534,387,638,480,1,104,93,586,433,0.915625,0.9020833333333333,0.1625,0.19375
BloodImage_00212.jpg,182.jpg,RBC,165,402,268,480,1,103,78,216,441,0.3375,0.91875,0.1609375,0.1625
BloodImage_00212.jpg,182.jpg,RBC,273,293,389,390,1,116,97,331,341,0.5171875,0.7104166666666667,0.18125,0.20208333333333334
BloodImage_00212.jpg,182.jpg,RBC,1,1,95,93,1,94,92,48,47,0.075,0.09791666666666667,0.146875,0.19166666666666668
BloodImage_00212.jpg,182.jpg,RBC,410,236,517,360,1,107,124,463,298,0.7234375,0.6208333333333333,0.1671875,0.25833333333333336
BloodImage_00212.jpg,182.jpg,RBC,349,1,458,111,1,109,110,403,56,0.6296875,0.11666666666666667,0.1703125,0.22916666666666666
BloodImage_00212.jpg,182.jpg,RBC,562,71,640,188,1,78,117,601,129,0.9390625,0.26875,0.121875,0.24375
BloodImage_00212.jpg,182.jpg,RBC,525,174,624,292,1,99,118,574,233,0.896875,0.48541666666666666,0.1546875,0.24583333333333332
BloodImage_00212.jpg,182.jpg,RBC,108,169,226,285,1,118,116,167,227,0.2609375,0.47291666666666665,0.184375,0.24166666666666667
BloodImage_00212.jpg,182.jpg,Platelets,233,1,281,46,0,48,45,257,23,0.4015625,0.04791666666666667,0.075,0.09375
BloodImage_00212.jpg,182.jpg,WBC,329,355,541,480,2,212,125,435,417,0.6796875,0.86875,0.33125,0.2604166666666667
BloodImage_00214.jpg,183.jpg,RBC,206,125,333,236,1,127,111,269,180,0.4203125,0.375,0.1984375,0.23125
BloodImage_00214.jpg,183.jpg,RBC,87,201,186,299,1,99,98,136,250,0.2125,0.5208333333333334,0.1546875,0.20416666666666666
BloodImage_00214.jpg,183.jpg,RBC,2,1,98,96,1,96,95,50,48,0.078125,0.1,0.15,0.19791666666666666
BloodImage_00214.jpg,183.jpg,RBC,31,98,155,195,1,124,97,93,146,0.1453125,0.30416666666666664,0.19375,0.20208333333333334
BloodImage_00214.jpg,183.jpg,RBC,284,258,380,344,1,96,86,332,301,0.51875,0.6270833333333333,0.15,0.17916666666666667
BloodImage_00214.jpg,183.jpg,RBC,252,306,356,418,1,104,112,304,362,0.475,0.7541666666666667,0.1625,0.23333333333333334
BloodImage_00214.jpg,183.jpg,RBC,237,361,341,473,1,104,112,289,417,0.4515625,0.86875,0.1625,0.23333333333333334
BloodImage_00214.jpg,183.jpg,RBC,390,226,508,311,1,118,85,449,268,0.7015625,0.5583333333333333,0.184375,0.17708333333333334
BloodImage_00214.jpg,183.jpg,RBC,487,408,600,480,1,113,72,543,444,0.8484375,0.925,0.1765625,0.15
BloodImage_00214.jpg,183.jpg,RBC,429,301,570,420,1,141,119,499,360,0.7796875,0.75,0.2203125,0.24791666666666667
BloodImage_00214.jpg,183.jpg,RBC,340,372,445,480,1,105,108,392,426,0.6125,0.8875,0.1640625,0.225
BloodImage_00214.jpg,183.jpg,RBC,513,1,633,98,1,120,97,573,49,0.8953125,0.10208333333333333,0.1875,0.20208333333333334
BloodImage_00214.jpg,183.jpg,RBC,146,341,249,446,1,103,105,197,393,0.3078125,0.81875,0.1609375,0.21875
BloodImage_00214.jpg,183.jpg,RBC,307,11,410,116,1,103,105,358,63,0.559375,0.13125,0.1609375,0.21875
BloodImage_00214.jpg,183.jpg,RBC,32,272,135,377,1,103,105,83,324,0.1296875,0.675,0.1609375,0.21875
BloodImage_00214.jpg,183.jpg,Platelets,253,47,294,94,0,41,47,273,70,0.4265625,0.14583333333333334,0.0640625,0.09791666666666667
BloodImage_00214.jpg,183.jpg,Platelets,1,75,34,123,0,33,48,17,99,0.0265625,0.20625,0.0515625,0.1
BloodImage_00214.jpg,183.jpg,WBC,365,64,564,232,2,199,168,464,148,0.725,0.30833333333333335,0.3109375,0.35
BloodImage_00215.jpg,184.jpg,RBC,407,57,519,158,1,112,101,463,107,0.7234375,0.22291666666666668,0.175,0.21041666666666667
BloodImage_00215.jpg,184.jpg,RBC,303,62,386,163,1,83,101,344,112,0.5375,0.23333333333333334,0.1296875,0.21041666666666667
BloodImage_00215.jpg,184.jpg,RBC,262,401,357,480,1,95,79,309,440,0.4828125,0.9166666666666666,0.1484375,0.16458333333333333
BloodImage_00215.jpg,184.jpg,RBC,239,187,329,293,1,90,106,284,240,0.44375,0.5,0.140625,0.22083333333333333
BloodImage_00215.jpg,184.jpg,RBC,230,56,305,147,1,75,91,267,101,0.4171875,0.21041666666666667,0.1171875,0.18958333333333333
BloodImage_00215.jpg,184.jpg,RBC,486,255,586,367,1,100,112,536,311,0.8375,0.6479166666666667,0.15625,0.23333333333333334
BloodImage_00215.jpg,184.jpg,RBC,448,355,541,441,1,93,86,494,398,0.771875,0.8291666666666667,0.1453125,0.17916666666666667
BloodImage_00215.jpg,184.jpg,RBC,537,403,636,480,1,99,77,586,441,0.915625,0.91875,0.1546875,0.16041666666666668
BloodImage_00215.jpg,184.jpg,RBC,396,429,495,480,1,99,51,445,454,0.6953125,0.9458333333333333,0.1546875,0.10625
BloodImage_00215.jpg,184.jpg,RBC,315,293,408,379,1,93,86,361,336,0.5640625,0.7,0.1453125,0.17916666666666667
BloodImage_00215.jpg,184.jpg,RBC,368,258,464,361,1,96,103,416,309,0.65,0.64375,0.15,0.21458333333333332
BloodImage_00215.jpg,184.jpg,RBC,4,383,101,480,1,97,97,52,431,0.08125,0.8979166666666667,0.1515625,0.20208333333333334
BloodImage_00215.jpg,184.jpg,RBC,1,262,66,378,1,65,116,33,320,0.0515625,0.6666666666666666,0.1015625,0.24166666666666667
BloodImage_00215.jpg,184.jpg,WBC,63,267,287,467,2,224,200,175,367,0.2734375,0.7645833333333333,0.35,0.4166666666666667
BloodImage_00215.jpg,184.jpg,Platelets,452,147,493,186,0,41,39,472,166,0.7375,0.3458333333333333,0.0640625,0.08125
BloodImage_00215.jpg,184.jpg,Platelets,579,254,628,294,0,49,40,603,274,0.9421875,0.5708333333333333,0.0765625,0.08333333333333333
BloodImage_00216.jpg,185.jpg,RBC,192,376,292,473,1,100,97,242,424,0.378125,0.8833333333333333,0.15625,0.20208333333333334
BloodImage_00216.jpg,185.jpg,RBC,301,320,419,424,1,118,104,360,372,0.5625,0.775,0.184375,0.21666666666666667
BloodImage_00216.jpg,185.jpg,RBC,433,273,510,358,1,77,85,471,315,0.7359375,0.65625,0.1203125,0.17708333333333334
BloodImage_00216.jpg,185.jpg,RBC,434,368,528,454,1,94,86,481,411,0.7515625,0.85625,0.146875,0.17916666666666667
BloodImage_00216.jpg,185.jpg,RBC,507,381,574,454,1,67,73,540,417,0.84375,0.86875,0.1046875,0.15208333333333332
BloodImage_00216.jpg,185.jpg,RBC,554,297,640,401,1,86,104,597,349,0.9328125,0.7270833333333333,0.134375,0.21666666666666667
BloodImage_00216.jpg,185.jpg,RBC,115,166,210,275,1,95,109,162,220,0.253125,0.4583333333333333,0.1484375,0.22708333333333333
BloodImage_00216.jpg,185.jpg,RBC,9,330,104,439,1,95,109,56,384,0.0875,0.8,0.1484375,0.22708333333333333
BloodImage_00216.jpg,185.jpg,RBC,23,254,121,356,1,98,102,72,305,0.1125,0.6354166666666666,0.153125,0.2125
BloodImage_00216.jpg,185.jpg,RBC,129,275,234,370,1,105,95,181,322,0.2828125,0.6708333333333333,0.1640625,0.19791666666666666
BloodImage_00216.jpg,185.jpg,RBC,96,337,186,415,1,90,78,141,376,0.2203125,0.7833333333333333,0.140625,0.1625
BloodImage_00216.jpg,185.jpg,RBC,169,110,264,219,1,95,109,216,164,0.3375,0.3416666666666667,0.1484375,0.22708333333333333
BloodImage_00216.jpg,185.jpg,RBC,320,1,426,108,1,106,107,373,54,0.5828125,0.1125,0.165625,0.22291666666666668
BloodImage_00216.jpg,185.jpg,RBC,531,48,624,164,1,93,116,577,106,0.9015625,0.22083333333333333,0.1453125,0.24166666666666667
BloodImage_00216.jpg,185.jpg,RBC,79,26,203,134,1,124,108,141,80,0.2203125,0.16666666666666666,0.19375,0.225
BloodImage_00216.jpg,185.jpg,WBC,274,101,473,334,2,199,233,373,217,0.5828125,0.45208333333333334,0.3109375,0.48541666666666666
BloodImage_00217.jpg,186.jpg,RBC,251,341,360,451,1,109,110,305,396,0.4765625,0.825,0.1703125,0.22916666666666666
BloodImage_00217.jpg,186.jpg,RBC,319,408,433,479,1,114,71,376,443,0.5875,0.9229166666666667,0.178125,0.14791666666666667
BloodImage_00217.jpg,186.jpg,RBC,407,327,516,437,1,109,110,461,382,0.7203125,0.7958333333333333,0.1703125,0.22916666666666666
BloodImage_00217.jpg,186.jpg,RBC,413,234,497,324,1,84,90,455,279,0.7109375,0.58125,0.13125,0.1875
BloodImage_00217.jpg,186.jpg,RBC,318,247,427,357,1,109,110,372,302,0.58125,0.6291666666666667,0.1703125,0.22916666666666666
BloodImage_00217.jpg,186.jpg,RBC,203,85,312,195,1,109,110,257,140,0.4015625,0.2916666666666667,0.1703125,0.22916666666666666
BloodImage_00217.jpg,186.jpg,RBC,156,107,262,211,1,106,104,209,159,0.3265625,0.33125,0.165625,0.21666666666666667
BloodImage_00217.jpg,186.jpg,RBC,281,1,384,70,1,103,69,332,35,0.51875,0.07291666666666667,0.1609375,0.14375
BloodImage_00217.jpg,186.jpg,RBC,389,91,498,201,1,109,110,443,146,0.6921875,0.30416666666666664,0.1703125,0.22916666666666666
BloodImage_00217.jpg,186.jpg,RBC,443,1,549,81,1,106,80,496,41,0.775,0.08541666666666667,0.165625,0.16666666666666666
BloodImage_00217.jpg,186.jpg,RBC,31,126,153,222,1,122,96,92,174,0.14375,0.3625,0.190625,0.2
BloodImage_00217.jpg,186.jpg,RBC,106,18,221,125,1,115,107,163,71,0.2546875,0.14791666666666667,0.1796875,0.22291666666666668
BloodImage_00217.jpg,186.jpg,WBC,73,242,234,391,2,161,149,153,316,0.2390625,0.6583333333333333,0.2515625,0.3104166666666667
BloodImage_00218.jpg,187.jpg,RBC,166,236,284,336,1,118,100,225,286,0.3515625,0.5958333333333333,0.184375,0.20833333333333334
BloodImage_00218.jpg,187.jpg,RBC,32,194,153,313,1,121,119,92,253,0.14375,0.5270833333333333,0.1890625,0.24791666666666667
BloodImage_00218.jpg,187.jpg,RBC,135,340,236,442,1,101,102,185,391,0.2890625,0.8145833333333333,0.1578125,0.2125
BloodImage_00218.jpg,187.jpg,RBC,51,304,152,406,1,101,102,101,355,0.1578125,0.7395833333333334,0.1578125,0.2125
BloodImage_00218.jpg,187.jpg,RBC,558,157,640,254,1,82,97,599,205,0.9359375,0.4270833333333333,0.128125,0.20208333333333334
BloodImage_00218.jpg,187.jpg,RBC,446,102,541,196,1,95,94,493,149,0.7703125,0.3104166666666667,0.1484375,0.19583333333333333
BloodImage_00218.jpg,187.jpg,RBC,255,1,370,110,1,115,109,312,55,0.4875,0.11458333333333333,0.1796875,0.22708333333333333
BloodImage_00218.jpg,187.jpg,RBC,73,43,195,160,1,122,117,134,101,0.209375,0.21041666666666667,0.190625,0.24375
BloodImage_00218.jpg,187.jpg,RBC,150,150,231,230,1,81,80,190,190,0.296875,0.3958333333333333,0.1265625,0.16666666666666666
BloodImage_00218.jpg,187.jpg,RBC,561,383,640,480,1,79,97,600,431,0.9375,0.8979166666666667,0.1234375,0.20208333333333334
BloodImage_00218.jpg,187.jpg,WBC,415,224,606,400,2,191,176,510,312,0.796875,0.65,0.2984375,0.36666666666666664
BloodImage_00219.jpg,188.jpg,RBC,47,204,146,313,1,99,109,96,258,0.15,0.5375,0.1546875,0.22708333333333333
BloodImage_00219.jpg,188.jpg,RBC,256,154,367,263,1,111,109,311,208,0.4859375,0.43333333333333335,0.1734375,0.22708333333333333
BloodImage_00219.jpg,188.jpg,RBC,285,384,400,480,1,115,96,342,432,0.534375,0.9,0.1796875,0.2
BloodImage_00219.jpg,188.jpg,RBC,169,384,289,480,1,120,96,229,432,0.3578125,0.9,0.1875,0.2
BloodImage_00219.jpg,188.jpg,RBC,396,384,522,479,1,126,95,459,431,0.7171875,0.8979166666666667,0.196875,0.19791666666666666
BloodImage_00219.jpg,188.jpg,RBC,156,55,272,157,1,116,102,214,106,0.334375,0.22083333333333333,0.18125,0.2125
BloodImage_00219.jpg,188.jpg,RBC,1,1,102,99,1,101,98,51,50,0.0796875,0.10416666666666667,0.1578125,0.20416666666666666
BloodImage_00219.jpg,188.jpg,RBC,454,304,537,390,1,83,86,495,347,0.7734375,0.7229166666666667,0.1296875,0.17916666666666667
BloodImage_00219.jpg,188.jpg,WBC,326,1,558,243,2,232,242,442,122,0.690625,0.25416666666666665,0.3625,0.5041666666666667
BloodImage_00220.jpg,189.jpg,RBC,11,73,128,189,1,117,116,69,131,0.1078125,0.27291666666666664,0.1828125,0.24166666666666667
BloodImage_00220.jpg,189.jpg,RBC,116,25,254,143,1,138,118,185,84,0.2890625,0.175,0.215625,0.24583333333333332
BloodImage_00220.jpg,189.jpg,RBC,547,337,640,429,1,93,92,593,383,0.9265625,0.7979166666666667,0.1453125,0.19166666666666668
BloodImage_00220.jpg,189.jpg,RBC,469,176,570,269,1,101,93,519,222,0.8109375,0.4625,0.1578125,0.19375
BloodImage_00220.jpg,189.jpg,RBC,214,190,321,283,1,107,93,267,236,0.4171875,0.49166666666666664,0.1671875,0.19375
BloodImage_00220.jpg,189.jpg,RBC,166,140,269,243,1,103,103,217,191,0.3390625,0.39791666666666664,0.1609375,0.21458333333333332
BloodImage_00220.jpg,189.jpg,RBC,354,330,458,437,1,104,107,406,383,0.634375,0.7979166666666667,0.1625,0.22291666666666668
BloodImage_00220.jpg,189.jpg,RBC,467,97,569,217,1,102,120,518,157,0.809375,0.32708333333333334,0.159375,0.25
BloodImage_00220.jpg,189.jpg,RBC,445,299,538,409,1,93,110,491,354,0.7671875,0.7375,0.1453125,0.22916666666666666
BloodImage_00220.jpg,189.jpg,WBC,262,17,467,221,2,205,204,364,119,0.56875,0.24791666666666667,0.3203125,0.425
BloodImage_00220.jpg,189.jpg,Platelets,27,190,72,236,0,45,46,49,213,0.0765625,0.44375,0.0703125,0.09583333333333334
BloodImage_00220.jpg,189.jpg,Platelets,545,418,593,453,0,48,35,569,435,0.8890625,0.90625,0.075,0.07291666666666667
BloodImage_00221.jpg,190.jpg,RBC,156,369,261,461,1,105,92,208,415,0.325,0.8645833333333334,0.1640625,0.19166666666666668
BloodImage_00221.jpg,190.jpg,RBC,516,213,632,319,1,116,106,574,266,0.896875,0.5541666666666667,0.18125,0.22083333333333333
BloodImage_00221.jpg,190.jpg,RBC,534,323,640,433,1,106,110,587,378,0.9171875,0.7875,0.165625,0.22916666666666666
BloodImage_00221.jpg,190.jpg,RBC,457,290,563,400,1,106,110,510,345,0.796875,0.71875,0.165625,0.22916666666666666
BloodImage_00221.jpg,190.jpg,RBC,362,336,484,444,1,122,108,423,390,0.6609375,0.8125,0.190625,0.225
BloodImage_00221.jpg,190.jpg,RBC,114,107,222,214,1,108,107,168,160,0.2625,0.3333333333333333,0.16875,0.22291666666666668
BloodImage_00221.jpg,190.jpg,RBC,97,215,208,340,1,111,125,152,277,0.2375,0.5770833333333333,0.1734375,0.2604166666666667
BloodImage_00221.jpg,190.jpg,RBC,401,1,508,113,1,107,112,454,57,0.709375,0.11875,0.1671875,0.23333333333333334
BloodImage_00221.jpg,190.jpg,RBC,136,1,238,71,1,102,70,187,36,0.2921875,0.075,0.159375,0.14583333333333334
BloodImage_00221.jpg,190.jpg,RBC,201,38,331,155,1,130,117,266,96,0.415625,0.2,0.203125,0.24375
BloodImage_00221.jpg,190.jpg,WBC,272,137,473,354,2,201,217,372,245,0.58125,0.5104166666666666,0.3140625,0.45208333333333334
BloodImage_00221.jpg,190.jpg,Platelets,181,287,219,332,0,38,45,200,309,0.3125,0.64375,0.059375,0.09375
BloodImage_00222.jpg,191.jpg,RBC,397,1,512,117,1,115,116,454,59,0.709375,0.12291666666666666,0.1796875,0.24166666666666667
BloodImage_00222.jpg,191.jpg,RBC,136,270,251,386,1,115,116,193,328,0.3015625,0.6833333333333333,0.1796875,0.24166666666666667
BloodImage_00222.jpg,191.jpg,RBC,242,270,357,386,1,115,116,299,328,0.4671875,0.6833333333333333,0.1796875,0.24166666666666667
BloodImage_00222.jpg,191.jpg,RBC,335,335,469,452,1,134,117,402,393,0.628125,0.81875,0.209375,0.24375
BloodImage_00222.jpg,191.jpg,RBC,465,290,559,403,1,94,113,512,346,0.8,0.7208333333333333,0.146875,0.23541666666666666
BloodImage_00222.jpg,191.jpg,RBC,38,78,150,175,1,112,97,94,126,0.146875,0.2625,0.175,0.20208333333333334
BloodImage_00222.jpg,191.jpg,RBC,293,1,385,68,1,92,67,339,34,0.5296875,0.07083333333333333,0.14375,0.13958333333333334
BloodImage_00222.jpg,191.jpg,RBC,397,120,512,236,1,115,116,454,178,0.709375,0.37083333333333335,0.1796875,0.24166666666666667
BloodImage_00222.jpg,191.jpg,RBC,1,161,73,275,1,72,114,37,218,0.0578125,0.45416666666666666,0.1125,0.2375
BloodImage_00222.jpg,191.jpg,Platelets,43,411,111,472,0,68,61,77,441,0.1203125,0.91875,0.10625,0.12708333333333333
BloodImage_00222.jpg,191.jpg,Platelets,200,408,239,449,0,39,41,219,428,0.3421875,0.8916666666666667,0.0609375,0.08541666666666667
BloodImage_00222.jpg,191.jpg,Platelets,79,174,125,228,0,46,54,102,201,0.159375,0.41875,0.071875,0.1125
BloodImage_00222.jpg,191.jpg,Platelets,609,121,640,169,0,31,48,624,145,0.975,0.3020833333333333,0.0484375,0.1
BloodImage_00222.jpg,191.jpg,WBC,140,27,340,230,2,200,203,240,128,0.375,0.26666666666666666,0.3125,0.42291666666666666
BloodImage_00223.jpg,192.jpg,RBC,115,345,226,427,1,111,82,170,386,0.265625,0.8041666666666667,0.1734375,0.17083333333333334
BloodImage_00223.jpg,192.jpg,RBC,1,318,112,400,1,111,82,56,359,0.0875,0.7479166666666667,0.1734375,0.17083333333333334
BloodImage_00223.jpg,192.jpg,RBC,265,377,344,476,1,79,99,304,426,0.475,0.8875,0.1234375,0.20625
BloodImage_00223.jpg,192.jpg,RBC,9,89,130,194,1,121,105,69,141,0.1078125,0.29375,0.1890625,0.21875
BloodImage_00223.jpg,192.jpg,RBC,84,166,205,271,1,121,105,144,218,0.225,0.45416666666666666,0.1890625,0.21875
BloodImage_00223.jpg,192.jpg,RBC,499,172,620,277,1,121,105,559,224,0.8734375,0.4666666666666667,0.1890625,0.21875
BloodImage_00223.jpg,192.jpg,RBC,431,159,552,264,1,121,105,491,211,0.7671875,0.4395833333333333,0.1890625,0.21875
BloodImage_00223.jpg,192.jpg,RBC,287,203,384,284,1,97,81,335,243,0.5234375,0.50625,0.1515625,0.16875
BloodImage_00223.jpg,192.jpg,RBC,32,1,154,94,1,122,93,93,47,0.1453125,0.09791666666666667,0.190625,0.19375
BloodImage_00223.jpg,192.jpg,RBC,531,68,613,172,1,82,104,572,120,0.89375,0.25,0.128125,0.21666666666666667
BloodImage_00223.jpg,192.jpg,RBC,536,332,639,455,1,103,123,587,393,0.9171875,0.81875,0.1609375,0.25625
BloodImage_00223.jpg,192.jpg,RBC,388,408,488,480,1,100,72,438,444,0.684375,0.925,0.15625,0.15
BloodImage_00223.jpg,192.jpg,Platelets,217,73,256,115,0,39,42,236,94,0.36875,0.19583333333333333,0.0609375,0.0875
BloodImage_00223.jpg,192.jpg,Platelets,519,36,562,85,0,43,49,540,60,0.84375,0.125,0.0671875,0.10208333333333333
BloodImage_00223.jpg,192.jpg,WBC,251,1,458,173,2,207,172,354,87,0.553125,0.18125,0.3234375,0.35833333333333334
BloodImage_00224.jpg,193.jpg,WBC,243,128,388,291,2,145,163,315,209,0.4921875,0.4354166666666667,0.2265625,0.33958333333333335
BloodImage_00224.jpg,193.jpg,Platelets,300,87,334,130,0,34,43,317,108,0.4953125,0.225,0.053125,0.08958333333333333
BloodImage_00225.jpg,194.jpg,RBC,41,272,137,371,1,96,99,89,321,0.1390625,0.66875,0.15,0.20625
BloodImage_00225.jpg,194.jpg,RBC,46,335,152,438,1,106,103,99,386,0.1546875,0.8041666666666667,0.165625,0.21458333333333332
BloodImage_00225.jpg,194.jpg,RBC,193,330,299,433,1,106,103,246,381,0.384375,0.79375,0.165625,0.21458333333333332
BloodImage_00225.jpg,194.jpg,RBC,206,252,312,355,1,106,103,259,303,0.4046875,0.63125,0.165625,0.21458333333333332
BloodImage_00225.jpg,194.jpg,RBC,156,251,241,340,1,85,89,198,295,0.309375,0.6145833333333334,0.1328125,0.18541666666666667
BloodImage_00225.jpg,194.jpg,RBC,415,191,517,283,1,102,92,466,237,0.728125,0.49375,0.159375,0.19166666666666668
BloodImage_00225.jpg,194.jpg,RBC,505,172,633,264,1,128,92,569,218,0.8890625,0.45416666666666666,0.2,0.19166666666666668
BloodImage_00225.jpg,194.jpg,RBC,176,93,277,192,1,101,99,226,142,0.353125,0.29583333333333334,0.1578125,0.20625
BloodImage_00225.jpg,194.jpg,RBC,1,112,98,227,1,97,115,49,169,0.0765625,0.35208333333333336,0.1515625,0.23958333333333334
BloodImage_00225.jpg,194.jpg,RBC,20,12,149,115,1,129,103,84,63,0.13125,0.13125,0.2015625,0.21458333333333332
BloodImage_00225.jpg,194.jpg,RBC,536,67,640,183,1,104,116,588,125,0.91875,0.2604166666666667,0.1625,0.24166666666666667
BloodImage_00225.jpg,194.jpg,RBC,487,386,615,472,1,128,86,551,429,0.8609375,0.89375,0.2,0.17916666666666667
BloodImage_00225.jpg,194.jpg,RBC,349,306,453,422,1,104,116,401,364,0.6265625,0.7583333333333333,0.1625,0.24166666666666667
BloodImage_00225.jpg,194.jpg,WBC,262,1,543,217,2,281,216,402,109,0.628125,0.22708333333333333,0.4390625,0.45
BloodImage_00226.jpg,195.jpg,RBC,51,159,138,267,1,87,108,94,213,0.146875,0.44375,0.1359375,0.225
BloodImage_00226.jpg,195.jpg,RBC,210,274,332,382,1,122,108,271,328,0.4234375,0.6833333333333333,0.190625,0.225
BloodImage_00226.jpg,195.jpg,RBC,515,186,605,288,1,90,102,560,237,0.875,0.49375,0.140625,0.2125
BloodImage_00226.jpg,195.jpg,RBC,423,161,528,265,1,105,104,475,213,0.7421875,0.44375,0.1640625,0.21666666666666667
BloodImage_00226.jpg,195.jpg,RBC,359,377,480,480,1,121,103,419,428,0.6546875,0.8916666666666667,0.1890625,0.21458333333333332
BloodImage_00226.jpg,195.jpg,RBC,254,409,378,480,1,124,71,316,444,0.49375,0.925,0.19375,0.14791666666666667
BloodImage_00226.jpg,195.jpg,RBC,146,409,237,480,1,91,71,191,444,0.2984375,0.925,0.1421875,0.14791666666666667
BloodImage_00226.jpg,195.jpg,RBC,69,424,148,480,1,79,56,108,452,0.16875,0.9416666666666667,0.1234375,0.11666666666666667
BloodImage_00226.jpg,195.jpg,RBC,115,89,210,172,1,95,83,162,130,0.253125,0.2708333333333333,0.1484375,0.17291666666666666
BloodImage_00226.jpg,195.jpg,RBC,209,1,319,83,1,110,82,264,42,0.4125,0.0875,0.171875,0.17083333333333334
BloodImage_00226.jpg,195.jpg,RBC,101,1,204,70,1,103,69,152,35,0.2375,0.07291666666666667,0.1609375,0.14375
BloodImage_00226.jpg,195.jpg,RBC,355,1,458,70,1,103,69,406,35,0.634375,0.07291666666666667,0.1609375,0.14375
BloodImage_00226.jpg,195.jpg,RBC,498,357,580,455,1,82,98,539,406,0.8421875,0.8458333333333333,0.128125,0.20416666666666666
BloodImage_00226.jpg,195.jpg,RBC,384,286,478,378,1,94,92,431,332,0.6734375,0.6916666666666667,0.146875,0.19166666666666668
BloodImage_00226.jpg,195.jpg,RBC,476,84,579,181,1,103,97,527,132,0.8234375,0.275,0.1609375,0.20208333333333334
BloodImage_00226.jpg,195.jpg,WBC,210,79,390,268,2,180,189,300,173,0.46875,0.36041666666666666,0.28125,0.39375
BloodImage_00226.jpg,195.jpg,Platelets,26,277,96,340,0,70,63,61,308,0.0953125,0.6416666666666667,0.109375,0.13125
BloodImage_00227.jpg,196.jpg,RBC,311,95,429,210,1,118,115,370,152,0.578125,0.31666666666666665,0.184375,0.23958333333333334
BloodImage_00227.jpg,196.jpg,RBC,1,59,95,157,1,94,98,48,108,0.075,0.225,0.146875,0.20416666666666666
BloodImage_00227.jpg,196.jpg,RBC,72,33,192,133,1,120,100,132,83,0.20625,0.17291666666666666,0.1875,0.20833333333333334
BloodImage_00227.jpg,196.jpg,RBC,52,380,153,473,1,101,93,102,426,0.159375,0.8875,0.1578125,0.19375
BloodImage_00227.jpg,196.jpg,RBC,424,403,546,479,1,122,76,485,441,0.7578125,0.91875,0.190625,0.15833333333333333
BloodImage_00227.jpg,196.jpg,RBC,522,52,612,145,1,90,93,567,98,0.8859375,0.20416666666666666,0.140625,0.19375
BloodImage_00227.jpg,196.jpg,RBC,411,172,501,265,1,90,93,456,218,0.7125,0.45416666666666666,0.140625,0.19375
BloodImage_00227.jpg,196.jpg,RBC,83,160,181,249,1,98,89,132,204,0.20625,0.425,0.153125,0.18541666666666667
BloodImage_00227.jpg,196.jpg,RBC,8,309,113,403,1,105,94,60,356,0.09375,0.7416666666666667,0.1640625,0.19583333333333333
BloodImage_00227.jpg,196.jpg,RBC,492,176,597,270,1,105,94,544,223,0.85,0.46458333333333335,0.1640625,0.19583333333333333
BloodImage_00227.jpg,196.jpg,RBC,425,1,522,87,1,97,86,473,44,0.7390625,0.09166666666666666,0.1515625,0.17916666666666667
BloodImage_00227.jpg,196.jpg,WBC,152,237,388,454,2,236,217,270,345,0.421875,0.71875,0.36875,0.45208333333333334
BloodImage_00228.jpg,197.jpg,RBC,209,347,313,436,1,104,89,261,391,0.4078125,0.8145833333333333,0.1625,0.18541666666666667
BloodImage_00228.jpg,197.jpg,RBC,285,278,405,376,1,120,98,345,327,0.5390625,0.68125,0.1875,0.20416666666666666
BloodImage_00228.jpg,197.jpg,RBC,106,269,215,389,1,109,120,160,329,0.25,0.6854166666666667,0.1703125,0.25
BloodImage_00228.jpg,197.jpg,RBC,103,170,204,276,1,101,106,153,223,0.2390625,0.46458333333333335,0.1578125,0.22083333333333333
BloodImage_00228.jpg,197.jpg,RBC,52,78,150,181,1,98,103,101,129,0.1578125,0.26875,0.153125,0.21458333333333332
BloodImage_00228.jpg,197.jpg,RBC,504,303,602,406,1,98,103,553,354,0.8640625,0.7375,0.153125,0.21458333333333332
BloodImage_00228.jpg,197.jpg,RBC,403,155,507,262,1,104,107,455,208,0.7109375,0.43333333333333335,0.1625,0.22291666666666668
BloodImage_00228.jpg,197.jpg,RBC,294,145,403,251,1,109,106,348,198,0.54375,0.4125,0.1703125,0.22083333333333333
BloodImage_00228.jpg,197.jpg,RBC,361,360,470,466,1,109,106,415,413,0.6484375,0.8604166666666667,0.1703125,0.22083333333333333
BloodImage_00228.jpg,197.jpg,RBC,28,255,137,361,1,109,106,82,308,0.128125,0.6416666666666667,0.1703125,0.22083333333333333
BloodImage_00228.jpg,197.jpg,RBC,34,1,143,62,1,109,61,88,31,0.1375,0.06458333333333334,0.1703125,0.12708333333333333
BloodImage_00229.jpg,198.jpg,RBC,106,282,215,409,1,109,127,160,345,0.25,0.71875,0.1703125,0.26458333333333334
BloodImage_00229.jpg,198.jpg,RBC,402,152,518,259,1,116,107,460,205,0.71875,0.4270833333333333,0.18125,0.22291666666666668
BloodImage_00229.jpg,198.jpg,RBC,462,68,554,178,1,92,110,508,123,0.79375,0.25625,0.14375,0.22916666666666666
BloodImage_00229.jpg,198.jpg,RBC,323,87,438,201,1,115,114,380,144,0.59375,0.3,0.1796875,0.2375
BloodImage_00229.jpg,198.jpg,RBC,524,275,617,387,1,93,112,570,331,0.890625,0.6895833333333333,0.1453125,0.23333333333333334
BloodImage_00229.jpg,198.jpg,RBC,24,306,110,410,1,86,104,67,358,0.1046875,0.7458333333333333,0.134375,0.21666666666666667
BloodImage_00229.jpg,198.jpg,RBC,115,111,218,214,1,103,103,166,162,0.259375,0.3375,0.1609375,0.21458333333333332
BloodImage_00229.jpg,198.jpg,RBC,33,201,165,293,1,132,92,99,247,0.1546875,0.5145833333333333,0.20625,0.19166666666666668
BloodImage_00229.jpg,198.jpg,RBC,226,1,337,64,1,111,63,281,32,0.4390625,0.06666666666666667,0.1734375,0.13125
BloodImage_00229.jpg,198.jpg,RBC,362,344,496,463,1,134,119,429,403,0.6703125,0.8395833333333333,0.209375,0.24791666666666667
BloodImage_00229.jpg,198.jpg,Platelets,225,194,268,233,0,43,39,246,213,0.384375,0.44375,0.0671875,0.08125
BloodImage_00229.jpg,198.jpg,Platelets,510,430,549,465,0,39,35,529,447,0.8265625,0.93125,0.0609375,0.07291666666666667
BloodImage_00229.jpg,198.jpg,WBC,192,256,363,417,2,171,161,277,336,0.4328125,0.7,0.2671875,0.33541666666666664
BloodImage_00230.jpg,199.jpg,RBC,154,246,270,356,1,116,110,212,301,0.33125,0.6270833333333333,0.18125,0.22916666666666666
BloodImage_00230.jpg,199.jpg,RBC,128,150,226,241,1,98,91,177,195,0.2765625,0.40625,0.153125,0.18958333333333333
BloodImage_00230.jpg,199.jpg,RBC,11,1,135,91,1,124,90,73,46,0.1140625,0.09583333333333334,0.19375,0.1875
BloodImage_00230.jpg,199.jpg,RBC,461,32,560,125,1,99,93,510,78,0.796875,0.1625,0.1546875,0.19375
BloodImage_00230.jpg,199.jpg,RBC,462,311,563,407,1,101,96,512,359,0.8,0.7479166666666667,0.1578125,0.2
BloodImage_00230.jpg,199.jpg,RBC,287,339,397,439,1,110,100,342,389,0.534375,0.8104166666666667,0.171875,0.20833333333333334
BloodImage_00230.jpg,199.jpg,RBC,8,201,145,308,1,137,107,76,254,0.11875,0.5291666666666667,0.2140625,0.22291666666666668
BloodImage_00230.jpg,199.jpg,RBC,1,107,91,198,1,90,91,46,152,0.071875,0.31666666666666665,0.140625,0.18958333333333333
BloodImage_00230.jpg,199.jpg,RBC,436,216,537,312,1,101,96,486,264,0.759375,0.55,0.1578125,0.2
BloodImage_00230.jpg,199.jpg,RBC,365,27,476,124,1,111,97,420,75,0.65625,0.15625,0.1734375,0.20208333333333334
BloodImage_00230.jpg,199.jpg,WBC,196,57,413,272,2,217,215,304,164,0.475,0.3416666666666667,0.3390625,0.4479166666666667
BloodImage_00231.jpg,200.jpg,RBC,408,135,536,250,1,128,115,472,192,0.7375,0.4,0.2,0.23958333333333334
BloodImage_00231.jpg,200.jpg,RBC,239,38,361,125,1,122,87,300,81,0.46875,0.16875,0.190625,0.18125
BloodImage_00231.jpg,200.jpg,RBC,371,23,488,136,1,117,113,429,79,0.6703125,0.16458333333333333,0.1828125,0.23541666666666666
BloodImage_00231.jpg,200.jpg,RBC,484,21,601,134,1,117,113,542,77,0.846875,0.16041666666666668,0.1828125,0.23541666666666666
BloodImage_00231.jpg,200.jpg,RBC,107,238,197,355,1,90,117,152,296,0.2375,0.6166666666666667,0.140625,0.24375
BloodImage_00231.jpg,200.jpg,RBC,1,137,92,235,1,91,98,46,186,0.071875,0.3875,0.1421875,0.20416666666666666
BloodImage_00231.jpg,200.jpg,RBC,582,232,640,326,1,58,94,611,279,0.9546875,0.58125,0.090625,0.19583333333333333
BloodImage_00231.jpg,200.jpg,RBC,72,1,177,86,1,105,85,124,43,0.19375,0.08958333333333333,0.1640625,0.17708333333333334
BloodImage_00231.jpg,200.jpg,WBC,172,209,406,427,2,234,218,289,318,0.4515625,0.6625,0.365625,0.45416666666666666
BloodImage_00232.jpg,201.jpg,RBC,509,177,614,291,1,105,114,561,234,0.8765625,0.4875,0.1640625,0.2375
BloodImage_00232.jpg,201.jpg,RBC,448,1,563,102,1,115,101,505,51,0.7890625,0.10625,0.1796875,0.21041666666666667
BloodImage_00232.jpg,201.jpg,RBC,340,261,453,371,1,113,110,396,316,0.61875,0.6583333333333333,0.1765625,0.22916666666666666
BloodImage_00232.jpg,201.jpg,RBC,239,364,344,471,1,105,107,291,417,0.4546875,0.86875,0.1640625,0.22291666666666668
BloodImage_00232.jpg,201.jpg,RBC,123,362,228,469,1,105,107,175,415,0.2734375,0.8645833333333334,0.1640625,0.22291666666666668
BloodImage_00232.jpg,201.jpg,RBC,137,44,242,151,1,105,107,189,97,0.2953125,0.20208333333333334,0.1640625,0.22291666666666668
BloodImage_00232.jpg,201.jpg,RBC,212,149,326,259,1,114,110,269,204,0.4203125,0.425,0.178125,0.22916666666666666
BloodImage_00232.jpg,201.jpg,RBC,458,275,562,374,1,104,99,510,324,0.796875,0.675,0.1625,0.20625
BloodImage_00232.jpg,201.jpg,RBC,415,332,519,431,1,104,99,467,381,0.7296875,0.79375,0.1625,0.20625
BloodImage_00232.jpg,201.jpg,WBC,1,60,176,304,2,175,244,88,182,0.1375,0.37916666666666665,0.2734375,0.5083333333333333
BloodImage_00233.jpg,202.jpg,RBC,1,164,89,257,1,88,93,45,210,0.0703125,0.4375,0.1375,0.19375
BloodImage_00233.jpg,202.jpg,RBC,46,67,171,177,1,125,110,108,122,0.16875,0.25416666666666665,0.1953125,0.22916666666666666
BloodImage_00233.jpg,202.jpg,RBC,289,88,396,196,1,107,108,342,142,0.534375,0.29583333333333334,0.1671875,0.225
BloodImage_00233.jpg,202.jpg,RBC,357,185,454,271,1,97,86,405,228,0.6328125,0.475,0.1515625,0.17916666666666667
BloodImage_00233.jpg,202.jpg,RBC,97,320,230,441,1,133,121,163,380,0.2546875,0.7916666666666666,0.2078125,0.2520833333333333
BloodImage_00233.jpg,202.jpg,RBC,13,324,99,395,1,86,71,56,359,0.0875,0.7479166666666667,0.134375,0.14791666666666667
BloodImage_00233.jpg,202.jpg,WBC,218,181,332,320,2,114,139,275,250,0.4296875,0.5208333333333334,0.178125,0.28958333333333336
BloodImage_00233.jpg,202.jpg,Platelets,106,236,181,309,0,75,73,143,272,0.2234375,0.5666666666666667,0.1171875,0.15208333333333332
BloodImage_00233.jpg,202.jpg,Platelets,51,34,89,79,0,38,45,70,56,0.109375,0.11666666666666667,0.059375,0.09375
BloodImage_00234.jpg,203.jpg,RBC,158,156,244,254,1,86,98,201,205,0.3140625,0.4270833333333333,0.134375,0.20416666666666666
BloodImage_00234.jpg,203.jpg,RBC,98,156,184,254,1,86,98,141,205,0.2203125,0.4270833333333333,0.134375,0.20416666666666666
BloodImage_00234.jpg,203.jpg,RBC,146,350,243,447,1,97,97,194,398,0.303125,0.8291666666666667,0.1515625,0.20208333333333334
BloodImage_00234.jpg,203.jpg,RBC,324,383,421,480,1,97,97,372,431,0.58125,0.8979166666666667,0.1515625,0.20208333333333334
BloodImage_00234.jpg,203.jpg,RBC,257,224,340,338,1,83,114,298,281,0.465625,0.5854166666666667,0.1296875,0.2375
BloodImage_00234.jpg,203.jpg,RBC,513,266,612,378,1,99,112,562,322,0.878125,0.6708333333333333,0.1546875,0.23333333333333334
BloodImage_00234.jpg,203.jpg,RBC,578,86,640,196,1,62,110,609,141,0.9515625,0.29375,0.096875,0.22916666666666666
BloodImage_00234.jpg,203.jpg,WBC,318,187,540,379,2,222,192,429,283,0.6703125,0.5895833333333333,0.346875,0.4
BloodImage_00234.jpg,203.jpg,RBC,137,69,242,164,1,105,95,189,116,0.2953125,0.24166666666666667,0.1640625,0.19791666666666666
BloodImage_00234.jpg,203.jpg,RBC,238,54,343,149,1,105,95,290,101,0.453125,0.21041666666666667,0.1640625,0.19791666666666666
BloodImage_00234.jpg,203.jpg,RBC,299,22,413,118,1,114,96,356,70,0.55625,0.14583333333333334,0.178125,0.2
BloodImage_00235.jpg,204.jpg,RBC,1,166,89,283,1,88,117,45,224,0.0703125,0.4666666666666667,0.1375,0.24375
BloodImage_00235.jpg,204.jpg,RBC,147,207,251,326,1,104,119,199,266,0.3109375,0.5541666666666667,0.1625,0.24791666666666667
BloodImage_00235.jpg,204.jpg,RBC,480,343,604,468,1,124,125,542,405,0.846875,0.84375,0.19375,0.2604166666666667
BloodImage_00235.jpg,204.jpg,WBC,232,102,469,336,2,237,234,350,219,0.546875,0.45625,0.3703125,0.4875
BloodImage_00236.jpg,205.jpg,RBC,514,187,633,293,1,119,106,573,240,0.8953125,0.5,0.1859375,0.22083333333333333
BloodImage_00236.jpg,205.jpg,RBC,381,53,486,191,1,105,138,433,122,0.6765625,0.25416666666666665,0.1640625,0.2875
BloodImage_00236.jpg,205.jpg,RBC,222,16,354,137,1,132,121,288,76,0.45,0.15833333333333333,0.20625,0.2520833333333333
BloodImage_00236.jpg,205.jpg,RBC,51,140,126,221,1,75,81,88,180,0.1375,0.375,0.1171875,0.16875
BloodImage_00236.jpg,205.jpg,RBC,1,100,63,208,1,62,108,32,154,0.05,0.32083333333333336,0.096875,0.225
BloodImage_00236.jpg,205.jpg,RBC,406,208,518,313,1,112,105,462,260,0.721875,0.5416666666666666,0.175,0.21875
BloodImage_00236.jpg,205.jpg,Platelets,100,415,131,445,0,31,30,115,430,0.1796875,0.8958333333333334,0.0484375,0.0625
BloodImage_00236.jpg,205.jpg,WBC,190,211,434,434,2,244,223,312,322,0.4875,0.6708333333333333,0.38125,0.46458333333333335
BloodImage_00236.jpg,205.jpg,Platelets,577,417,618,455,0,41,38,597,436,0.9328125,0.9083333333333333,0.0640625,0.07916666666666666
BloodImage_00237.jpg,206.jpg,RBC,1,276,70,379,1,69,103,35,327,0.0546875,0.68125,0.1078125,0.21458333333333332
BloodImage_00237.jpg,206.jpg,RBC,182,355,310,458,1,128,103,246,406,0.384375,0.8458333333333333,0.2,0.21458333333333332
BloodImage_00237.jpg,206.jpg,RBC,101,222,199,327,1,98,105,150,274,0.234375,0.5708333333333333,0.153125,0.21875
BloodImage_00237.jpg,206.jpg,RBC,515,177,620,293,1,105,116,567,235,0.8859375,0.4895833333333333,0.1640625,0.24166666666666667
BloodImage_00237.jpg,206.jpg,RBC,358,402,453,480,1,95,78,405,441,0.6328125,0.91875,0.1484375,0.1625
BloodImage_00237.jpg,206.jpg,RBC,71,399,179,480,1,108,81,125,439,0.1953125,0.9145833333333333,0.16875,0.16875
BloodImage_00237.jpg,206.jpg,RBC,1,1,92,103,1,91,102,46,52,0.071875,0.10833333333333334,0.1421875,0.2125
BloodImage_00237.jpg,206.jpg,RBC,405,191,509,294,1,104,103,457,242,0.7140625,0.5041666666666667,0.1625,0.21458333333333332
BloodImage_00237.jpg,206.jpg,RBC,189,242,317,350,1,128,108,253,296,0.3953125,0.6166666666666667,0.2,0.225
BloodImage_00237.jpg,206.jpg,RBC,301,314,418,417,1,117,103,359,365,0.5609375,0.7604166666666666,0.1828125,0.21458333333333332
BloodImage_00237.jpg,206.jpg,RBC,98,163,177,236,1,79,73,137,199,0.2140625,0.41458333333333336,0.1234375,0.15208333333333332
BloodImage_00237.jpg,206.jpg,WBC,206,51,437,272,2,231,221,321,161,0.5015625,0.33541666666666664,0.3609375,0.46041666666666664
BloodImage_00239.jpg,207.jpg,RBC,360,170,469,286,1,109,116,414,228,0.646875,0.475,0.1703125,0.24166666666666667
BloodImage_00239.jpg,207.jpg,RBC,375,1,479,110,1,104,109,427,55,0.6671875,0.11458333333333333,0.1625,0.22708333333333333
BloodImage_00239.jpg,207.jpg,RBC,239,156,362,294,1,123,138,300,225,0.46875,0.46875,0.1921875,0.2875
BloodImage_00239.jpg,207.jpg,RBC,478,188,581,284,1,103,96,529,236,0.8265625,0.49166666666666664,0.1609375,0.2
BloodImage_00239.jpg,207.jpg,RBC,449,86,541,183,1,92,97,495,134,0.7734375,0.2791666666666667,0.14375,0.20208333333333334
BloodImage_00239.jpg,207.jpg,RBC,146,24,246,117,1,100,93,196,70,0.30625,0.14583333333333334,0.15625,0.19375
BloodImage_00239.jpg,207.jpg,RBC,51,267,167,354,1,116,87,109,310,0.1703125,0.6458333333333334,0.18125,0.18125
BloodImage_00239.jpg,207.jpg,RBC,169,234,258,312,1,89,78,213,273,0.3328125,0.56875,0.1390625,0.1625
BloodImage_00239.jpg,207.jpg,RBC,174,283,264,396,1,90,113,219,339,0.3421875,0.70625,0.140625,0.23541666666666666
BloodImage_00239.jpg,207.jpg,RBC,573,198,640,336,1,67,138,606,267,0.946875,0.55625,0.1046875,0.2875
BloodImage_00239.jpg,207.jpg,RBC,93,113,208,238,1,115,125,150,175,0.234375,0.3645833333333333,0.1796875,0.2604166666666667
BloodImage_00239.jpg,207.jpg,WBC,242,266,457,471,2,215,205,349,368,0.5453125,0.7666666666666667,0.3359375,0.4270833333333333
BloodImage_00240.jpg,208.jpg,RBC,373,277,477,385,1,104,108,425,331,0.6640625,0.6895833333333333,0.1625,0.225
BloodImage_00240.jpg,208.jpg,RBC,188,267,313,390,1,125,123,250,328,0.390625,0.6833333333333333,0.1953125,0.25625
BloodImage_00240.jpg,208.jpg,RBC,279,149,404,272,1,125,123,341,210,0.5328125,0.4375,0.1953125,0.25625
BloodImage_00240.jpg,208.jpg,RBC,141,1,270,71,1,129,70,205,36,0.3203125,0.075,0.2015625,0.14583333333333334
BloodImage_00240.jpg,208.jpg,RBC,74,236,170,326,1,96,90,122,281,0.190625,0.5854166666666667,0.15,0.1875
BloodImage_00240.jpg,208.jpg,RBC,39,111,135,201,1,96,90,87,156,0.1359375,0.325,0.15,0.1875
BloodImage_00240.jpg,208.jpg,RBC,144,311,240,401,1,96,90,192,356,0.3,0.7416666666666667,0.15,0.1875
BloodImage_00240.jpg,208.jpg,RBC,443,364,539,454,1,96,90,491,409,0.7671875,0.8520833333333333,0.15,0.1875
BloodImage_00240.jpg,208.jpg,Platelets,343,270,380,302,0,37,32,361,286,0.5640625,0.5958333333333333,0.0578125,0.06666666666666667
BloodImage_00240.jpg,208.jpg,WBC,371,1,613,192,2,242,191,492,96,0.76875,0.2,0.378125,0.39791666666666664
BloodImage_00241.jpg,209.jpg,RBC,396,113,492,207,1,96,94,444,160,0.69375,0.3333333333333333,0.15,0.19583333333333333
BloodImage_00241.jpg,209.jpg,RBC,183,119,277,285,1,94,166,230,202,0.359375,0.42083333333333334,0.146875,0.3458333333333333
BloodImage_00241.jpg,209.jpg,RBC,377,204,482,315,1,105,111,429,259,0.6703125,0.5395833333333333,0.1640625,0.23125
BloodImage_00241.jpg,209.jpg,RBC,490,91,624,235,1,134,144,557,163,0.8703125,0.33958333333333335,0.209375,0.3
BloodImage_00241.jpg,209.jpg,RBC,527,1,640,97,1,113,96,583,49,0.9109375,0.10208333333333333,0.1765625,0.2
BloodImage_00241.jpg,209.jpg,RBC,92,264,202,370,1,110,106,147,317,0.2296875,0.6604166666666667,0.171875,0.22083333333333333
BloodImage_00241.jpg,209.jpg,WBC,249,25,446,205,2,197,180,347,115,0.5421875,0.23958333333333334,0.3078125,0.375
BloodImage_00242.jpg,210.jpg,RBC,331,110,425,199,1,94,89,378,154,0.590625,0.32083333333333336,0.146875,0.18541666666666667
BloodImage_00242.jpg,210.jpg,RBC,212,318,325,433,1,113,115,268,375,0.41875,0.78125,0.1765625,0.23958333333333334
BloodImage_00242.jpg,210.jpg,RBC,138,54,262,177,1,124,123,200,115,0.3125,0.23958333333333334,0.19375,0.25625
BloodImage_00242.jpg,210.jpg,RBC,101,16,180,87,1,79,71,140,51,0.21875,0.10625,0.1234375,0.14791666666666667
BloodImage_00242.jpg,210.jpg,RBC,276,14,380,122,1,104,108,328,68,0.5125,0.14166666666666666,0.1625,0.225
BloodImage_00242.jpg,210.jpg,RBC,444,96,534,189,1,90,93,489,142,0.7640625,0.29583333333333334,0.140625,0.19375
BloodImage_00242.jpg,210.jpg,RBC,531,309,640,415,1,109,106,585,362,0.9140625,0.7541666666666667,0.1703125,0.22083333333333333
BloodImage_00242.jpg,210.jpg,RBC,559,212,640,311,1,81,99,599,261,0.9359375,0.54375,0.1265625,0.20625
BloodImage_00242.jpg,210.jpg,RBC,463,228,556,323,1,93,95,509,275,0.7953125,0.5729166666666666,0.1453125,0.19791666666666666
BloodImage_00242.jpg,210.jpg,RBC,539,107,639,202,1,100,95,589,154,0.9203125,0.32083333333333336,0.15625,0.19791666666666666
BloodImage_00242.jpg,210.jpg,RBC,465,422,565,480,1,100,58,515,451,0.8046875,0.9395833333333333,0.15625,0.12083333333333333
BloodImage_00242.jpg,210.jpg,RBC,445,317,547,415,1,102,98,496,366,0.775,0.7625,0.159375,0.20416666666666666
BloodImage_00242.jpg,210.jpg,RBC,1,158,99,273,1,98,115,50,215,0.078125,0.4479166666666667,0.153125,0.23958333333333334
BloodImage_00242.jpg,210.jpg,RBC,290,154,392,258,1,102,104,341,206,0.5328125,0.42916666666666664,0.159375,0.21666666666666667
BloodImage_00242.jpg,210.jpg,WBC,17,184,242,398,2,225,214,129,291,0.2015625,0.60625,0.3515625,0.44583333333333336
BloodImage_00242.jpg,210.jpg,Platelets,245,121,286,158,0,41,37,265,139,0.4140625,0.28958333333333336,0.0640625,0.07708333333333334
BloodImage_00243.jpg,211.jpg,RBC,118,24,229,151,1,111,127,173,87,0.2703125,0.18125,0.1734375,0.26458333333333334
BloodImage_00243.jpg,211.jpg,RBC,418,150,511,250,1,93,100,464,200,0.725,0.4166666666666667,0.1453125,0.20833333333333334
BloodImage_00243.jpg,211.jpg,RBC,303,1,409,79,1,106,78,356,40,0.55625,0.08333333333333333,0.165625,0.1625
BloodImage_00243.jpg,211.jpg,RBC,284,134,392,240,1,108,106,338,187,0.528125,0.38958333333333334,0.16875,0.22083333333333333
BloodImage_00243.jpg,211.jpg,RBC,37,187,145,279,1,108,92,91,233,0.1421875,0.48541666666666666,0.16875,0.19166666666666668
BloodImage_00243.jpg,211.jpg,RBC,145,243,256,320,1,111,77,200,281,0.3125,0.5854166666666667,0.1734375,0.16041666666666668
BloodImage_00243.jpg,211.jpg,RBC,156,138,256,229,1,100,91,206,183,0.321875,0.38125,0.15625,0.18958333333333333
BloodImage_00243.jpg,211.jpg,RBC,500,229,598,342,1,98,113,549,285,0.8578125,0.59375,0.153125,0.23541666666666666
BloodImage_00243.jpg,211.jpg,RBC,1,70,98,183,1,97,113,49,126,0.0765625,0.2625,0.1515625,0.23541666666666666
BloodImage_00243.jpg,211.jpg,RBC,332,29,457,143,1,125,114,394,86,0.615625,0.17916666666666667,0.1953125,0.2375
BloodImage_00243.jpg,211.jpg,RBC,307,407,438,479,1,131,72,372,443,0.58125,0.9229166666666667,0.2046875,0.15
BloodImage_00243.jpg,211.jpg,WBC,285,217,487,419,2,202,202,386,318,0.603125,0.6625,0.315625,0.42083333333333334
BloodImage_00244.jpg,212.jpg,RBC,329,386,413,480,1,84,94,371,433,0.5796875,0.9020833333333333,0.13125,0.19583333333333333
BloodImage_00244.jpg,212.jpg,RBC,125,355,223,451,1,98,96,174,403,0.271875,0.8395833333333333,0.153125,0.2
BloodImage_00244.jpg,212.jpg,RBC,1,331,98,427,1,97,96,49,379,0.0765625,0.7895833333333333,0.1515625,0.2
BloodImage_00244.jpg,212.jpg,RBC,78,266,176,362,1,98,96,127,314,0.1984375,0.6541666666666667,0.153125,0.2
BloodImage_00244.jpg,212.jpg,RBC,24,1,124,82,1,100,81,74,41,0.115625,0.08541666666666667,0.15625,0.16875
BloodImage_00244.jpg,212.jpg,RBC,157,1,272,104,1,115,103,214,52,0.334375,0.10833333333333334,0.1796875,0.21458333333333332
BloodImage_00244.jpg,212.jpg,RBC,283,1,379,109,1,96,108,331,55,0.5171875,0.11458333333333333,0.15,0.225
BloodImage_00244.jpg,212.jpg,RBC,523,1,625,62,1,102,61,574,31,0.896875,0.06458333333333334,0.159375,0.12708333333333333
BloodImage_00244.jpg,212.jpg,RBC,524,100,629,204,1,105,104,576,152,0.9,0.31666666666666665,0.1640625,0.21666666666666667
BloodImage_00244.jpg,212.jpg,RBC,535,364,640,468,1,105,104,587,416,0.9171875,0.8666666666666667,0.1640625,0.21666666666666667
BloodImage_00244.jpg,212.jpg,RBC,349,273,472,384,1,123,111,410,328,0.640625,0.6833333333333333,0.1921875,0.23125
BloodImage_00244.jpg,212.jpg,RBC,295,185,418,296,1,123,111,356,240,0.55625,0.5,0.1921875,0.23125
BloodImage_00244.jpg,212.jpg,RBC,32,157,140,248,1,108,91,86,202,0.134375,0.42083333333333334,0.16875,0.18958333333333333
BloodImage_00244.jpg,212.jpg,RBC,192,239,313,349,1,121,110,252,294,0.39375,0.6125,0.1890625,0.22916666666666666
BloodImage_00244.jpg,212.jpg,WBC,326,36,538,230,2,212,194,432,133,0.675,0.27708333333333335,0.33125,0.4041666666666667
BloodImage_00245.jpg,213.jpg,RBC,332,365,436,459,1,104,94,384,412,0.6,0.8583333333333333,0.1625,0.19583333333333333
BloodImage_00245.jpg,213.jpg,RBC,229,398,327,480,1,98,82,278,439,0.434375,0.9145833333333333,0.153125,0.17083333333333334
BloodImage_00245.jpg,213.jpg,RBC,509,118,612,225,1,103,107,560,171,0.875,0.35625,0.1609375,0.22291666666666668
BloodImage_00245.jpg,213.jpg,RBC,408,9,511,116,1,103,107,459,62,0.7171875,0.12916666666666668,0.1609375,0.22291666666666668
BloodImage_00245.jpg,213.jpg,RBC,292,87,407,194,1,115,107,349,140,0.5453125,0.2916666666666667,0.1796875,0.22291666666666668
BloodImage_00245.jpg,213.jpg,RBC,328,174,419,282,1,91,108,373,228,0.5828125,0.475,0.1421875,0.225
BloodImage_00245.jpg,213.jpg,RBC,270,255,361,363,1,91,108,315,309,0.4921875,0.64375,0.1421875,0.225
BloodImage_00245.jpg,213.jpg,RBC,321,291,390,368,1,69,77,355,329,0.5546875,0.6854166666666667,0.1078125,0.16041666666666668
BloodImage_00245.jpg,213.jpg,RBC,1,29,62,133,1,61,104,31,81,0.0484375,0.16875,0.0953125,0.21666666666666667
BloodImage_00245.jpg,213.jpg,RBC,30,104,145,211,1,115,107,87,157,0.1359375,0.32708333333333334,0.1796875,0.22291666666666668
BloodImage_00245.jpg,213.jpg,RBC,213,55,311,160,1,98,105,262,107,0.409375,0.22291666666666668,0.153125,0.21875
BloodImage_00245.jpg,213.jpg,RBC,274,1,374,77,1,100,76,324,39,0.50625,0.08125,0.15625,0.15833333333333333
BloodImage_00245.jpg,213.jpg,RBC,108,51,226,148,1,118,97,167,99,0.2609375,0.20625,0.184375,0.20208333333333334
BloodImage_00245.jpg,213.jpg,RBC,484,365,587,472,1,103,107,535,418,0.8359375,0.8708333333333333,0.1609375,0.22291666666666668
BloodImage_00245.jpg,213.jpg,RBC,1,382,74,474,1,73,92,37,428,0.0578125,0.8916666666666667,0.1140625,0.19166666666666668
BloodImage_00245.jpg,213.jpg,WBC,77,154,281,357,2,204,203,179,255,0.2796875,0.53125,0.31875,0.42291666666666666
BloodImage_00245.jpg,213.jpg,Platelets,9,323,43,352,0,34,29,26,337,0.040625,0.7020833333333333,0.053125,0.06041666666666667
BloodImage_00246.jpg,214.jpg,RBC,316,202,426,276,1,110,74,371,239,0.5796875,0.4979166666666667,0.171875,0.15416666666666667
BloodImage_00246.jpg,214.jpg,RBC,370,17,460,123,1,90,106,415,70,0.6484375,0.14583333333333334,0.140625,0.22083333333333333
BloodImage_00246.jpg,214.jpg,RBC,176,2,291,113,1,115,111,233,57,0.3640625,0.11875,0.1796875,0.23125
BloodImage_00246.jpg,214.jpg,RBC,1,232,97,364,1,96,132,49,298,0.0765625,0.6208333333333333,0.15,0.275
BloodImage_00246.jpg,214.jpg,RBC,88,217,192,324,1,104,107,140,270,0.21875,0.5625,0.1625,0.22291666666666668
BloodImage_00246.jpg,214.jpg,RBC,202,194,304,283,1,102,89,253,238,0.3953125,0.49583333333333335,0.159375,0.18541666666666667
BloodImage_00246.jpg,214.jpg,RBC,380,273,476,389,1,96,116,428,331,0.66875,0.6895833333333333,0.15,0.24166666666666667
BloodImage_00246.jpg,214.jpg,RBC,470,214,560,363,1,90,149,515,288,0.8046875,0.6,0.140625,0.3104166666666667
BloodImage_00246.jpg,214.jpg,RBC,559,212,640,358,1,81,146,599,285,0.9359375,0.59375,0.1265625,0.30416666666666664
BloodImage_00246.jpg,214.jpg,RBC,513,75,625,177,1,112,102,569,126,0.8890625,0.2625,0.175,0.2125
BloodImage_00246.jpg,214.jpg,RBC,354,116,467,204,1,113,88,410,160,0.640625,0.3333333333333333,0.1765625,0.18333333333333332
BloodImage_00246.jpg,214.jpg,RBC,396,392,509,480,1,113,88,452,436,0.70625,0.9083333333333333,0.1765625,0.18333333333333332
BloodImage_00246.jpg,214.jpg,Platelets,127,156,167,201,0,40,45,147,178,0.2296875,0.37083333333333335,0.0625,0.09375
BloodImage_00246.jpg,214.jpg,WBC,132,274,355,480,2,223,206,243,377,0.3796875,0.7854166666666667,0.3484375,0.42916666666666664
BloodImage_00247.jpg,215.jpg,RBC,374,16,479,112,1,105,96,426,64,0.665625,0.13333333333333333,0.1640625,0.2
BloodImage_00247.jpg,215.jpg,RBC,479,22,584,118,1,105,96,531,70,0.8296875,0.14583333333333334,0.1640625,0.2
BloodImage_00247.jpg,215.jpg,RBC,381,144,486,240,1,105,96,433,192,0.6765625,0.4,0.1640625,0.2
BloodImage_00247.jpg,215.jpg,RBC,214,333,327,438,1,113,105,270,385,0.421875,0.8020833333333334,0.1765625,0.21875
BloodImage_00247.jpg,215.jpg,RBC,139,227,258,349,1,119,122,198,288,0.309375,0.6,0.1859375,0.25416666666666665
BloodImage_00247.jpg,215.jpg,RBC,137,58,232,158,1,95,100,184,108,0.2875,0.225,0.1484375,0.20833333333333334
BloodImage_00247.jpg,215.jpg,RBC,439,341,558,463,1,119,122,498,402,0.778125,0.8375,0.1859375,0.25416666666666665
BloodImage_00247.jpg,215.jpg,RBC,387,413,489,479,1,102,66,438,446,0.684375,0.9291666666666667,0.159375,0.1375
BloodImage_00247.jpg,215.jpg,RBC,510,220,629,300,1,119,80,569,260,0.8890625,0.5416666666666666,0.1859375,0.16666666666666666
BloodImage_00247.jpg,215.jpg,RBC,13,27,130,154,1,117,127,71,90,0.1109375,0.1875,0.1828125,0.26458333333333334
BloodImage_00247.jpg,215.jpg,RBC,228,1,318,82,1,90,81,273,41,0.4265625,0.08541666666666667,0.140625,0.16875
BloodImage_00247.jpg,215.jpg,RBC,148,322,266,413,1,118,91,207,367,0.3234375,0.7645833333333333,0.184375,0.18958333333333333
BloodImage_00247.jpg,215.jpg,RBC,336,321,444,434,1,108,113,390,377,0.609375,0.7854166666666667,0.16875,0.23541666666666666
BloodImage_00247.jpg,215.jpg,WBC,184,85,388,295,2,204,210,286,190,0.446875,0.3958333333333333,0.31875,0.4375
BloodImage_00248.jpg,216.jpg,RBC,381,1,488,87,1,107,86,434,44,0.678125,0.09166666666666666,0.1671875,0.17916666666666667
BloodImage_00248.jpg,216.jpg,RBC,481,24,592,123,1,111,99,536,73,0.8375,0.15208333333333332,0.1734375,0.20625
BloodImage_00248.jpg,216.jpg,RBC,259,79,383,198,1,124,119,321,138,0.5015625,0.2875,0.19375,0.24791666666666667
BloodImage_00248.jpg,216.jpg,RBC,154,1,256,68,1,102,67,205,34,0.3203125,0.07083333333333333,0.159375,0.13958333333333334
BloodImage_00248.jpg,216.jpg,RBC,2,220,129,331,1,127,111,65,275,0.1015625,0.5729166666666666,0.1984375,0.23125
BloodImage_00248.jpg,216.jpg,RBC,308,373,402,480,1,94,107,355,426,0.5546875,0.8875,0.146875,0.22291666666666668
BloodImage_00248.jpg,216.jpg,RBC,102,47,218,151,1,116,104,160,99,0.25,0.20625,0.18125,0.21666666666666667
BloodImage_00248.jpg,216.jpg,RBC,348,187,464,291,1,116,104,406,239,0.634375,0.4979166666666667,0.18125,0.21666666666666667
BloodImage_00248.jpg,216.jpg,RBC,462,222,578,326,1,116,104,520,274,0.8125,0.5708333333333333,0.18125,0.21666666666666667
BloodImage_00248.jpg,216.jpg,RBC,159,414,291,478,1,132,64,225,446,0.3515625,0.9291666666666667,0.20625,0.13333333333333333
BloodImage_00248.jpg,216.jpg,RBC,1,357,84,454,1,83,97,42,405,0.065625,0.84375,0.1296875,0.20208333333333334
BloodImage_00248.jpg,216.jpg,WBC,149,233,354,423,2,205,190,251,328,0.3921875,0.6833333333333333,0.3203125,0.3958333333333333
BloodImage_00249.jpg,217.jpg,WBC,70,329,277,480,2,207,151,173,404,0.2703125,0.8416666666666667,0.3234375,0.3145833333333333
BloodImage_00249.jpg,217.jpg,WBC,164,20,362,205,2,198,185,263,112,0.4109375,0.23333333333333334,0.309375,0.3854166666666667
BloodImage_00249.jpg,217.jpg,Platelets,278,268,311,298,0,33,30,294,283,0.459375,0.5895833333333333,0.0515625,0.0625
BloodImage_00250.jpg,218.jpg,WBC,125,143,324,344,2,199,201,224,243,0.35,0.50625,0.3109375,0.41875
BloodImage_00251.jpg,219.jpg,RBC,475,145,583,235,1,108,90,529,190,0.8265625,0.3958333333333333,0.16875,0.1875
BloodImage_00251.jpg,219.jpg,RBC,207,149,315,239,1,108,90,261,194,0.4078125,0.4041666666666667,0.16875,0.1875
BloodImage_00251.jpg,219.jpg,RBC,12,232,120,322,1,108,90,66,277,0.103125,0.5770833333333333,0.16875,0.1875
BloodImage_00251.jpg,219.jpg,RBC,492,365,600,455,1,108,90,546,410,0.853125,0.8541666666666666,0.16875,0.1875
BloodImage_00251.jpg,219.jpg,RBC,515,318,623,408,1,108,90,569,363,0.8890625,0.75625,0.16875,0.1875
BloodImage_00251.jpg,219.jpg,RBC,109,171,225,273,1,116,102,167,222,0.2609375,0.4625,0.18125,0.2125
BloodImage_00251.jpg,219.jpg,RBC,3,329,119,442,1,116,113,61,385,0.0953125,0.8020833333333334,0.18125,0.23541666666666666
BloodImage_00251.jpg,219.jpg,RBC,1,327,117,440,1,116,113,59,383,0.0921875,0.7979166666666667,0.18125,0.23541666666666666
BloodImage_00251.jpg,219.jpg,WBC,309,199,551,417,2,242,218,430,308,0.671875,0.6416666666666667,0.378125,0.45416666666666666
BloodImage_00252.jpg,220.jpg,RBC,177,48,278,147,1,101,99,227,97,0.3546875,0.20208333333333334,0.1578125,0.20625
BloodImage_00252.jpg,220.jpg,RBC,65,355,166,454,1,101,99,115,404,0.1796875,0.8416666666666667,0.1578125,0.20625
BloodImage_00252.jpg,220.jpg,RBC,564,395,640,480,1,76,85,602,437,0.940625,0.9104166666666667,0.11875,0.17708333333333334
BloodImage_00252.jpg,220.jpg,RBC,472,315,582,423,1,110,108,527,369,0.8234375,0.76875,0.171875,0.225
BloodImage_00252.jpg,220.jpg,RBC,156,380,279,480,1,123,100,217,430,0.3390625,0.8958333333333334,0.1921875,0.20833333333333334
BloodImage_00252.jpg,220.jpg,RBC,296,50,394,148,1,98,98,345,99,0.5390625,0.20625,0.153125,0.20416666666666666
BloodImage_00252.jpg,220.jpg,RBC,456,21,569,116,1,113,95,512,68,0.8,0.14166666666666666,0.1765625,0.19791666666666666
BloodImage_00252.jpg,220.jpg,RBC,55,1,174,99,1,119,98,114,50,0.178125,0.10416666666666667,0.1859375,0.20416666666666666
BloodImage_00252.jpg,220.jpg,RBC,61,295,138,363,1,77,68,99,329,0.1546875,0.6854166666666667,0.1203125,0.14166666666666666
BloodImage_00252.jpg,220.jpg,WBC,161,181,399,404,2,238,223,280,292,0.4375,0.6083333333333333,0.371875,0.46458333333333335
BloodImage_00253.jpg,221.jpg,RBC,47,222,134,312,1,87,90,90,267,0.140625,0.55625,0.1359375,0.1875
BloodImage_00253.jpg,221.jpg,RBC,51,46,138,136,1,87,90,94,91,0.146875,0.18958333333333333,0.1359375,0.1875
BloodImage_00253.jpg,221.jpg,RBC,138,36,259,122,1,121,86,198,79,0.309375,0.16458333333333333,0.1890625,0.17916666666666667
BloodImage_00253.jpg,221.jpg,RBC,277,36,383,126,1,106,90,330,81,0.515625,0.16875,0.165625,0.1875
BloodImage_00253.jpg,221.jpg,RBC,510,267,632,381,1,122,114,571,324,0.8921875,0.675,0.190625,0.2375
BloodImage_00253.jpg,221.jpg,RBC,469,62,556,165,1,87,103,512,113,0.8,0.23541666666666666,0.1359375,0.21458333333333332
BloodImage_00253.jpg,221.jpg,RBC,97,377,184,480,1,87,103,140,428,0.21875,0.8916666666666667,0.1359375,0.21458333333333332
BloodImage_00253.jpg,221.jpg,RBC,500,377,640,477,1,140,100,570,427,0.890625,0.8895833333333333,0.21875,0.20833333333333334
BloodImage_00253.jpg,221.jpg,RBC,422,296,518,395,1,96,99,470,345,0.734375,0.71875,0.15,0.20625
BloodImage_00253.jpg,221.jpg,WBC,195,287,434,480,2,239,193,314,383,0.490625,0.7979166666666667,0.3734375,0.40208333333333335
BloodImage_00254.jpg,222.jpg,RBC,393,54,502,162,1,109,108,447,108,0.6984375,0.225,0.1703125,0.225
BloodImage_00254.jpg,222.jpg,RBC,400,350,494,438,1,94,88,447,394,0.6984375,0.8208333333333333,0.146875,0.18333333333333332
BloodImage_00254.jpg,222.jpg,RBC,81,239,209,335,1,128,96,145,287,0.2265625,0.5979166666666667,0.2,0.2
BloodImage_00254.jpg,222.jpg,RBC,330,258,434,368,1,104,110,382,313,0.596875,0.6520833333333333,0.1625,0.22916666666666666
BloodImage_00254.jpg,222.jpg,RBC,1,325,104,425,1,103,100,52,375,0.08125,0.78125,0.1609375,0.20833333333333334
BloodImage_00254.jpg,222.jpg,RBC,223,244,323,332,1,100,88,273,288,0.4265625,0.6,0.15625,0.18333333333333332
BloodImage_00254.jpg,222.jpg,RBC,179,184,299,270,1,120,86,239,227,0.3734375,0.47291666666666665,0.1875,0.17916666666666667
BloodImage_00254.jpg,222.jpg,RBC,110,32,220,151,1,110,119,165,91,0.2578125,0.18958333333333333,0.171875,0.24791666666666667
BloodImage_00254.jpg,222.jpg,RBC,525,374,614,480,1,89,106,569,427,0.8890625,0.8895833333333333,0.1390625,0.22083333333333333
BloodImage_00254.jpg,222.jpg,Platelets,161,400,216,469,0,55,69,188,434,0.29375,0.9041666666666667,0.0859375,0.14375
BloodImage_00254.jpg,222.jpg,Platelets,82,202,122,243,0,40,41,102,222,0.159375,0.4625,0.0625,0.08541666666666667
BloodImage_00254.jpg,222.jpg,WBC,241,349,379,477,2,138,128,310,413,0.484375,0.8604166666666667,0.215625,0.26666666666666666
BloodImage_00255.jpg,223.jpg,RBC,1,317,75,426,1,74,109,38,371,0.059375,0.7729166666666667,0.115625,0.22708333333333333
BloodImage_00255.jpg,223.jpg,RBC,183,413,312,480,1,129,67,247,446,0.3859375,0.9291666666666667,0.2015625,0.13958333333333334
BloodImage_00255.jpg,223.jpg,RBC,130,420,234,480,1,104,60,182,450,0.284375,0.9375,0.1625,0.125
BloodImage_00255.jpg,223.jpg,RBC,503,360,592,449,1,89,89,547,404,0.8546875,0.8416666666666667,0.1390625,0.18541666666666667
BloodImage_00255.jpg,223.jpg,RBC,299,297,411,387,1,112,90,355,342,0.5546875,0.7125,0.175,0.1875
BloodImage_00255.jpg,223.jpg,RBC,517,37,628,143,1,111,106,572,90,0.89375,0.1875,0.1734375,0.22083333333333333
BloodImage_00255.jpg,223.jpg,RBC,68,140,153,230,1,85,90,110,185,0.171875,0.3854166666666667,0.1328125,0.1875
BloodImage_00255.jpg,223.jpg,RBC,129,254,214,344,1,85,90,171,299,0.2671875,0.6229166666666667,0.1328125,0.1875
BloodImage_00255.jpg,223.jpg,RBC,35,209,150,321,1,115,112,92,265,0.14375,0.5520833333333334,0.1796875,0.23333333333333334
BloodImage_00255.jpg,223.jpg,RBC,441,293,547,362,1,106,69,494,327,0.771875,0.68125,0.165625,0.14375
BloodImage_00255.jpg,223.jpg,RBC,542,260,631,349,1,89,89,586,304,0.915625,0.6333333333333333,0.1390625,0.18541666666666667
BloodImage_00255.jpg,223.jpg,WBC,283,42,551,294,2,268,252,417,168,0.6515625,0.35,0.41875,0.525
BloodImage_00256.jpg,224.jpg,RBC,455,132,596,259,1,141,127,525,195,0.8203125,0.40625,0.2203125,0.26458333333333334
BloodImage_00256.jpg,224.jpg,RBC,1,85,110,175,1,109,90,55,130,0.0859375,0.2708333333333333,0.1703125,0.1875
BloodImage_00256.jpg,224.jpg,RBC,296,40,423,131,1,127,91,359,85,0.5609375,0.17708333333333334,0.1984375,0.18958333333333333
BloodImage_00256.jpg,224.jpg,RBC,115,205,211,305,1,96,100,163,255,0.2546875,0.53125,0.15,0.20833333333333334
BloodImage_00256.jpg,224.jpg,RBC,58,136,154,236,1,96,100,106,186,0.165625,0.3875,0.15,0.20833333333333334
BloodImage_00256.jpg,224.jpg,WBC,217,214,470,443,2,253,229,343,328,0.5359375,0.6833333333333333,0.3953125,0.47708333333333336
BloodImage_00257.jpg,225.jpg,RBC,426,353,542,456,1,116,103,484,404,0.75625,0.8416666666666667,0.18125,0.21458333333333332
BloodImage_00257.jpg,225.jpg,RBC,254,377,370,480,1,116,103,312,428,0.4875,0.8916666666666667,0.18125,0.21458333333333332
BloodImage_00257.jpg,225.jpg,RBC,118,290,253,395,1,135,105,185,342,0.2890625,0.7125,0.2109375,0.21875
BloodImage_00257.jpg,225.jpg,RBC,106,198,193,287,1,87,89,149,242,0.2328125,0.5041666666666667,0.1359375,0.18541666666666667
BloodImage_00257.jpg,225.jpg,RBC,174,1,281,77,1,107,76,227,39,0.3546875,0.08125,0.1671875,0.15833333333333333
BloodImage_00257.jpg,225.jpg,RBC,429,78,530,179,1,101,101,479,128,0.7484375,0.26666666666666666,0.1578125,0.21041666666666667
BloodImage_00257.jpg,225.jpg,RBC,539,295,640,396,1,101,101,589,345,0.9203125,0.71875,0.1578125,0.21041666666666667
BloodImage_00257.jpg,225.jpg,WBC,174,99,385,306,2,211,207,279,202,0.4359375,0.42083333333333334,0.3296875,0.43125
BloodImage_00258.jpg,226.jpg,Platelets,257,162,300,202,0,43,40,278,182,0.434375,0.37916666666666665,0.0671875,0.08333333333333333
BloodImage_00258.jpg,226.jpg,WBC,221,223,386,387,2,165,164,303,305,0.4734375,0.6354166666666666,0.2578125,0.3416666666666667
BloodImage_00258.jpg,226.jpg,Platelets,541,394,582,435,0,41,41,561,414,0.8765625,0.8625,0.0640625,0.08541666666666667
BloodImage_00259.jpg,227.jpg,RBC,156,112,256,206,1,100,94,206,159,0.321875,0.33125,0.15625,0.19583333333333333
BloodImage_00259.jpg,227.jpg,RBC,168,374,270,477,1,102,103,219,425,0.3421875,0.8854166666666666,0.159375,0.21458333333333332
BloodImage_00259.jpg,227.jpg,RBC,238,228,320,284,1,82,56,279,256,0.4359375,0.5333333333333333,0.128125,0.11666666666666667
BloodImage_00259.jpg,227.jpg,RBC,456,161,564,251,1,108,90,510,206,0.796875,0.42916666666666664,0.16875,0.1875
BloodImage_00259.jpg,227.jpg,RBC,537,299,640,414,1,103,115,588,356,0.91875,0.7416666666666667,0.1609375,0.23958333333333334
BloodImage_00259.jpg,227.jpg,RBC,61,63,185,145,1,124,82,123,104,0.1921875,0.21666666666666667,0.19375,0.17083333333333334
BloodImage_00259.jpg,227.jpg,RBC,7,420,107,480,1,100,60,57,450,0.0890625,0.9375,0.15625,0.125
BloodImage_00259.jpg,227.jpg,Platelets,38,129,87,179,0,49,50,62,154,0.096875,0.32083333333333336,0.0765625,0.10416666666666667
BloodImage_00259.jpg,227.jpg,Platelets,281,182,326,225,0,45,43,303,203,0.4734375,0.42291666666666666,0.0703125,0.08958333333333333
BloodImage_00259.jpg,227.jpg,Platelets,585,419,624,456,0,39,37,604,437,0.94375,0.9104166666666667,0.0609375,0.07708333333333334
BloodImage_00259.jpg,227.jpg,Platelets,507,340,547,377,0,40,37,527,358,0.8234375,0.7458333333333333,0.0625,0.07708333333333334
BloodImage_00259.jpg,227.jpg,WBC,15,181,209,362,2,194,181,112,271,0.175,0.5645833333333333,0.303125,0.3770833333333333
BloodImage_00260.jpg,228.jpg,RBC,45,88,146,180,1,101,92,95,134,0.1484375,0.2791666666666667,0.1578125,0.19166666666666668
BloodImage_00260.jpg,228.jpg,RBC,361,124,484,234,1,123,110,422,179,0.659375,0.3729166666666667,0.1921875,0.22916666666666666
BloodImage_00260.jpg,228.jpg,RBC,95,414,199,479,1,104,65,147,446,0.2296875,0.9291666666666667,0.1625,0.13541666666666666
BloodImage_00260.jpg,228.jpg,RBC,118,68,247,150,1,129,82,182,109,0.284375,0.22708333333333333,0.2015625,0.17083333333333334
BloodImage_00260.jpg,228.jpg,RBC,1,3,101,100,1,100,97,51,51,0.0796875,0.10625,0.15625,0.20208333333333334
BloodImage_00260.jpg,228.jpg,WBC,205,267,434,480,2,229,213,319,373,0.4984375,0.7770833333333333,0.3578125,0.44375
BloodImage_00261.jpg,229.jpg,RBC,107,250,200,358,1,93,108,153,304,0.2390625,0.6333333333333333,0.1453125,0.225
BloodImage_00261.jpg,229.jpg,RBC,278,358,408,467,1,130,109,343,412,0.5359375,0.8583333333333333,0.203125,0.22708333333333333
BloodImage_00261.jpg,229.jpg,RBC,426,62,529,163,1,103,101,477,112,0.7453125,0.23333333333333334,0.1609375,0.21041666666666667
BloodImage_00261.jpg,229.jpg,RBC,266,69,388,171,1,122,102,327,120,0.5109375,0.25,0.190625,0.2125
BloodImage_00261.jpg,229.jpg,RBC,162,65,274,175,1,112,110,218,120,0.340625,0.25,0.175,0.22916666666666666
BloodImage_00261.jpg,229.jpg,RBC,492,250,596,355,1,104,105,544,302,0.85,0.6291666666666667,0.1625,0.21875
BloodImage_00261.jpg,229.jpg,RBC,544,176,640,287,1,96,111,592,231,0.925,0.48125,0.15,0.23125
BloodImage_00261.jpg,229.jpg,RBC,5,179,135,288,1,130,109,70,233,0.109375,0.48541666666666666,0.203125,0.22708333333333333
BloodImage_00261.jpg,229.jpg,Platelets,91,368,164,428,0,73,60,127,398,0.1984375,0.8291666666666667,0.1140625,0.125
BloodImage_00261.jpg,229.jpg,WBC,274,163,460,350,2,186,187,367,256,0.5734375,0.5333333333333333,0.290625,0.38958333333333334
BloodImage_00262.jpg,230.jpg,RBC,524,279,640,385,1,116,106,582,332,0.909375,0.6916666666666667,0.18125,0.22083333333333333
BloodImage_00262.jpg,230.jpg,RBC,419,252,530,354,1,111,102,474,303,0.740625,0.63125,0.1734375,0.2125
BloodImage_00262.jpg,230.jpg,RBC,542,134,640,242,1,98,108,591,188,0.9234375,0.39166666666666666,0.153125,0.225
BloodImage_00262.jpg,230.jpg,RBC,1,202,56,305,1,55,103,28,253,0.04375,0.5270833333333333,0.0859375,0.21458333333333332
BloodImage_00262.jpg,230.jpg,RBC,214,148,325,262,1,111,114,269,205,0.4203125,0.4270833333333333,0.1734375,0.2375
BloodImage_00262.jpg,230.jpg,RBC,293,62,426,180,1,133,118,359,121,0.5609375,0.2520833333333333,0.2078125,0.24583333333333332
BloodImage_00262.jpg,230.jpg,RBC,448,394,553,480,1,105,86,500,437,0.78125,0.9104166666666667,0.1640625,0.17916666666666667
BloodImage_00262.jpg,230.jpg,RBC,429,75,531,183,1,102,108,480,129,0.75,0.26875,0.159375,0.225
BloodImage_00262.jpg,230.jpg,RBC,104,221,218,331,1,114,110,161,276,0.2515625,0.575,0.178125,0.22916666666666666
BloodImage_00262.jpg,230.jpg,WBC,170,268,454,480,2,284,212,312,374,0.4875,0.7791666666666667,0.44375,0.44166666666666665
BloodImage_00263.jpg,231.jpg,RBC,115,358,206,446,1,91,88,160,402,0.25,0.8375,0.1421875,0.18333333333333332
BloodImage_00263.jpg,231.jpg,RBC,1,315,79,401,1,78,86,40,358,0.0625,0.7458333333333333,0.121875,0.17916666666666667
BloodImage_00263.jpg,231.jpg,RBC,402,305,486,414,1,84,109,444,359,0.69375,0.7479166666666667,0.13125,0.22708333333333333
BloodImage_00263.jpg,231.jpg,RBC,388,43,467,143,1,79,100,427,93,0.6671875,0.19375,0.1234375,0.20833333333333334
BloodImage_00263.jpg,231.jpg,RBC,564,1,640,77,1,76,76,602,39,0.940625,0.08125,0.11875,0.15833333333333333
BloodImage_00263.jpg,231.jpg,RBC,248,382,346,480,1,98,98,297,431,0.4640625,0.8979166666666667,0.153125,0.20416666666666666
BloodImage_00263.jpg,231.jpg,RBC,337,411,402,480,1,65,69,369,445,0.5765625,0.9270833333333334,0.1015625,0.14375
BloodImage_00263.jpg,231.jpg,RBC,140,171,242,255,1,102,84,191,213,0.2984375,0.44375,0.159375,0.175
BloodImage_00263.jpg,231.jpg,RBC,50,192,152,276,1,102,84,101,234,0.1578125,0.4875,0.159375,0.175
BloodImage_00263.jpg,231.jpg,RBC,356,148,462,249,1,106,101,409,198,0.6390625,0.4125,0.165625,0.21041666666666667
BloodImage_00263.jpg,231.jpg,RBC,298,128,406,236,1,108,108,352,182,0.55,0.37916666666666665,0.16875,0.225
BloodImage_00263.jpg,231.jpg,RBC,534,243,640,344,1,106,101,587,293,0.9171875,0.6104166666666667,0.165625,0.21041666666666667
BloodImage_00263.jpg,231.jpg,Platelets,70,38,112,94,0,42,56,91,66,0.1421875,0.1375,0.065625,0.11666666666666667
BloodImage_00263.jpg,231.jpg,Platelets,361,12,419,56,0,58,44,390,34,0.609375,0.07083333333333333,0.090625,0.09166666666666666
BloodImage_00263.jpg,231.jpg,WBC,100,1,307,144,2,207,143,203,72,0.3171875,0.15,0.3234375,0.29791666666666666
BloodImage_00264.jpg,232.jpg,RBC,153,309,243,394,1,90,85,198,351,0.309375,0.73125,0.140625,0.17708333333333334
BloodImage_00264.jpg,232.jpg,RBC,131,401,224,480,1,93,79,177,440,0.2765625,0.9166666666666666,0.1453125,0.16458333333333333
BloodImage_00264.jpg,232.jpg,RBC,377,176,484,285,1,107,109,430,230,0.671875,0.4791666666666667,0.1671875,0.22708333333333333
BloodImage_00264.jpg,232.jpg,RBC,486,274,575,362,1,89,88,530,318,0.828125,0.6625,0.1390625,0.18333333333333332
BloodImage_00264.jpg,232.jpg,RBC,434,1,516,74,1,82,73,475,37,0.7421875,0.07708333333333334,0.128125,0.15208333333333332
BloodImage_00264.jpg,232.jpg,RBC,481,55,592,154,1,111,99,536,104,0.8375,0.21666666666666667,0.1734375,0.20625
BloodImage_00264.jpg,232.jpg,RBC,90,118,184,206,1,94,88,137,162,0.2140625,0.3375,0.146875,0.18333333333333332
BloodImage_00264.jpg,232.jpg,RBC,274,137,374,230,1,100,93,324,183,0.50625,0.38125,0.15625,0.19375
BloodImage_00264.jpg,232.jpg,RBC,515,1,615,50,1,100,49,565,25,0.8828125,0.052083333333333336,0.15625,0.10208333333333333
BloodImage_00264.jpg,232.jpg,RBC,561,132,640,231,1,79,99,600,181,0.9375,0.3770833333333333,0.1234375,0.20625
BloodImage_00264.jpg,232.jpg,RBC,589,304,640,388,1,51,84,614,346,0.959375,0.7208333333333333,0.0796875,0.175
BloodImage_00264.jpg,232.jpg,RBC,527,392,638,480,1,111,88,582,436,0.909375,0.9083333333333333,0.1734375,0.18333333333333332
BloodImage_00264.jpg,232.jpg,RBC,271,18,398,114,1,127,96,334,66,0.521875,0.1375,0.1984375,0.2
BloodImage_00264.jpg,232.jpg,WBC,234,332,369,480,2,135,148,301,406,0.4703125,0.8458333333333333,0.2109375,0.30833333333333335
BloodImage_00264.jpg,232.jpg,Platelets,282,296,324,339,0,42,43,303,317,0.4734375,0.6604166666666667,0.065625,0.08958333333333333
BloodImage_00265.jpg,233.jpg,RBC,144,346,242,436,1,98,90,193,391,0.3015625,0.8145833333333333,0.153125,0.1875
BloodImage_00265.jpg,233.jpg,RBC,1,72,82,160,1,81,88,41,116,0.0640625,0.24166666666666667,0.1265625,0.18333333333333332
BloodImage_00265.jpg,233.jpg,RBC,107,1,203,65,1,96,64,155,33,0.2421875,0.06875,0.15,0.13333333333333333
BloodImage_00265.jpg,233.jpg,RBC,200,1,311,86,1,111,85,255,43,0.3984375,0.08958333333333333,0.1734375,0.17708333333333334
BloodImage_00265.jpg,233.jpg,RBC,71,77,182,163,1,111,86,126,120,0.196875,0.25,0.1734375,0.17916666666666667
BloodImage_00265.jpg,233.jpg,RBC,35,252,127,356,1,92,104,81,304,0.1265625,0.6333333333333333,0.14375,0.21666666666666667
BloodImage_00265.jpg,233.jpg,RBC,75,295,146,386,1,71,91,110,340,0.171875,0.7083333333333334,0.1109375,0.18958333333333333
BloodImage_00265.jpg,233.jpg,RBC,29,350,129,457,1,100,107,79,403,0.1234375,0.8395833333333333,0.15625,0.22291666666666668
BloodImage_00265.jpg,233.jpg,RBC,209,108,309,215,1,100,107,259,161,0.4046875,0.33541666666666664,0.15625,0.22291666666666668
BloodImage_00265.jpg,233.jpg,RBC,477,134,561,218,1,84,84,519,176,0.8109375,0.36666666666666664,0.13125,0.175
BloodImage_00265.jpg,233.jpg,WBC,240,219,438,393,2,198,174,339,306,0.5296875,0.6375,0.309375,0.3625
BloodImage_00266.jpg,234.jpg,RBC,509,147,621,254,1,112,107,565,200,0.8828125,0.4166666666666667,0.175,0.22291666666666668
BloodImage_00266.jpg,234.jpg,RBC,444,146,514,258,1,70,112,479,202,0.7484375,0.42083333333333334,0.109375,0.23333333333333334
BloodImage_00266.jpg,234.jpg,RBC,345,219,457,328,1,112,109,401,273,0.6265625,0.56875,0.175,0.22708333333333333
BloodImage_00266.jpg,234.jpg,RBC,287,340,407,445,1,120,105,347,392,0.5421875,0.8166666666666667,0.1875,0.21875
BloodImage_00266.jpg,234.jpg,RBC,1,154,86,245,1,85,91,43,199,0.0671875,0.41458333333333336,0.1328125,0.18958333333333333
BloodImage_00266.jpg,234.jpg,RBC,303,87,389,178,1,86,91,346,132,0.540625,0.275,0.134375,0.18958333333333333
BloodImage_00266.jpg,234.jpg,RBC,380,12,466,103,1,86,91,423,57,0.6609375,0.11875,0.134375,0.18958333333333333
BloodImage_00266.jpg,234.jpg,RBC,563,251,639,350,1,76,99,601,300,0.9390625,0.625,0.11875,0.20625
BloodImage_00266.jpg,234.jpg,RBC,83,1,182,99,1,99,98,132,50,0.20625,0.10416666666666667,0.1546875,0.20416666666666666
BloodImage_00266.jpg,234.jpg,RBC,52,88,163,181,1,111,93,107,134,0.1671875,0.2791666666666667,0.1734375,0.19375
BloodImage_00266.jpg,234.jpg,WBC,2,247,187,440,2,185,193,94,343,0.146875,0.7145833333333333,0.2890625,0.40208333333333335
BloodImage_00266.jpg,234.jpg,Platelets,579,423,623,456,0,44,33,601,439,0.9390625,0.9145833333333333,0.06875,0.06875
BloodImage_00266.jpg,234.jpg,RBC,311,323,409,394,1,98,71,360,358,0.5625,0.7458333333333333,0.153125,0.14791666666666667
BloodImage_00266.jpg,234.jpg,RBC,174,211,288,283,1,114,72,231,247,0.3609375,0.5145833333333333,0.178125,0.15
BloodImage_00267.jpg,235.jpg,WBC,87,112,298,298,2,211,186,192,205,0.3,0.4270833333333333,0.3296875,0.3875
BloodImage_00267.jpg,235.jpg,Platelets,62,26,101,73,0,39,47,81,49,0.1265625,0.10208333333333333,0.0609375,0.09791666666666667
BloodImage_00267.jpg,235.jpg,Platelets,15,309,53,350,0,38,41,34,329,0.053125,0.6854166666666667,0.059375,0.08541666666666667
BloodImage_00267.jpg,235.jpg,Platelets,1,349,38,381,0,37,32,19,365,0.0296875,0.7604166666666666,0.0578125,0.06666666666666667
BloodImage_00268.jpg,236.jpg,WBC,124,1,328,172,2,204,171,226,86,0.353125,0.17916666666666667,0.31875,0.35625
BloodImage_00269.jpg,237.jpg,RBC,499,79,603,185,1,104,106,551,132,0.8609375,0.275,0.1625,0.22083333333333333
BloodImage_00269.jpg,237.jpg,RBC,340,100,436,194,1,96,94,388,147,0.60625,0.30625,0.15,0.19583333333333333
BloodImage_00269.jpg,237.jpg,RBC,258,255,366,356,1,108,101,312,305,0.4875,0.6354166666666666,0.16875,0.21041666666666667
BloodImage_00269.jpg,237.jpg,RBC,356,166,465,289,1,109,123,410,227,0.640625,0.47291666666666665,0.1703125,0.25625
BloodImage_00269.jpg,237.jpg,RBC,78,265,177,354,1,99,89,127,309,0.1984375,0.64375,0.1546875,0.18541666666666667
BloodImage_00269.jpg,237.jpg,RBC,260,178,356,268,1,96,90,308,223,0.48125,0.46458333333333335,0.15,0.1875
BloodImage_00269.jpg,237.jpg,RBC,544,324,640,443,1,96,119,592,383,0.925,0.7979166666666667,0.15,0.24791666666666667
BloodImage_00269.jpg,237.jpg,RBC,500,195,589,274,1,89,79,544,234,0.85,0.4875,0.1390625,0.16458333333333333
BloodImage_00269.jpg,237.jpg,Platelets,192,220,238,259,0,46,39,215,239,0.3359375,0.4979166666666667,0.071875,0.08125
BloodImage_00269.jpg,237.jpg,WBC,75,11,340,226,2,265,215,207,118,0.3234375,0.24583333333333332,0.4140625,0.4479166666666667
BloodImage_00270.jpg,238.jpg,Platelets,83,298,140,340,0,57,42,111,319,0.1734375,0.6645833333333333,0.0890625,0.0875
BloodImage_00270.jpg,238.jpg,Platelets,349,327,391,365,0,42,38,370,346,0.578125,0.7208333333333333,0.065625,0.07916666666666666
BloodImage_00270.jpg,238.jpg,WBC,245,352,383,480,2,138,128,314,416,0.490625,0.8666666666666667,0.215625,0.26666666666666666
BloodImage_00270.jpg,238.jpg,RBC,270,118,372,210,1,102,92,321,164,0.5015625,0.3416666666666667,0.159375,0.19166666666666668
BloodImage_00270.jpg,238.jpg,RBC,314,87,416,179,1,102,92,365,133,0.5703125,0.27708333333333335,0.159375,0.19166666666666668
BloodImage_00270.jpg,238.jpg,RBC,161,283,287,383,1,126,100,224,333,0.35,0.69375,0.196875,0.20833333333333334
BloodImage_00271.jpg,239.jpg,RBC,507,337,613,455,1,106,118,560,396,0.875,0.825,0.165625,0.24583333333333332
BloodImage_00271.jpg,239.jpg,RBC,562,278,640,373,1,78,95,601,325,0.9390625,0.6770833333333334,0.121875,0.19791666666666666
BloodImage_00271.jpg,239.jpg,RBC,503,181,618,295,1,115,114,560,238,0.875,0.49583333333333335,0.1796875,0.2375
BloodImage_00271.jpg,239.jpg,RBC,129,204,229,308,1,100,104,179,256,0.2796875,0.5333333333333333,0.15625,0.21666666666666667
BloodImage_00271.jpg,239.jpg,RBC,321,353,405,459,1,84,106,363,406,0.5671875,0.8458333333333333,0.13125,0.22083333333333333
BloodImage_00271.jpg,239.jpg,RBC,355,355,455,459,1,100,104,405,407,0.6328125,0.8479166666666667,0.15625,0.21666666666666667
BloodImage_00271.jpg,239.jpg,RBC,74,24,190,145,1,116,121,132,84,0.20625,0.175,0.18125,0.2520833333333333
BloodImage_00271.jpg,239.jpg,RBC,463,1,577,77,1,114,76,520,39,0.8125,0.08125,0.178125,0.15833333333333333
BloodImage_00271.jpg,239.jpg,RBC,75,366,175,470,1,100,104,125,418,0.1953125,0.8708333333333333,0.15625,0.21666666666666667
BloodImage_00271.jpg,239.jpg,RBC,141,344,233,425,1,92,81,187,384,0.2921875,0.8,0.14375,0.16875
BloodImage_00271.jpg,239.jpg,RBC,348,250,446,350,1,98,100,397,300,0.6203125,0.625,0.153125,0.20833333333333334
BloodImage_00271.jpg,239.jpg,WBC,183,60,380,264,2,197,204,281,162,0.4390625,0.3375,0.3078125,0.425
BloodImage_00271.jpg,239.jpg,Platelets,526,123,558,164,0,32,41,542,143,0.846875,0.29791666666666666,0.05,0.08541666666666667
BloodImage_00272.jpg,240.jpg,RBC,37,402,137,480,1,100,78,87,441,0.1359375,0.91875,0.15625,0.1625
BloodImage_00272.jpg,240.jpg,RBC,35,46,141,147,1,106,101,88,96,0.1375,0.2,0.165625,0.21041666666666667
BloodImage_00272.jpg,240.jpg,RBC,98,125,194,248,1,96,123,146,186,0.228125,0.3875,0.15,0.25625
BloodImage_00272.jpg,240.jpg,RBC,184,184,259,308,1,75,124,221,246,0.3453125,0.5125,0.1171875,0.25833333333333336
BloodImage_00272.jpg,240.jpg,RBC,191,66,297,167,1,106,101,244,116,0.38125,0.24166666666666667,0.165625,0.21041666666666667
BloodImage_00272.jpg,240.jpg,RBC,284,83,408,182,1,124,99,346,132,0.540625,0.275,0.19375,0.20625
BloodImage_00272.jpg,240.jpg,RBC,265,1,390,93,1,125,92,327,47,0.5109375,0.09791666666666667,0.1953125,0.19166666666666668
BloodImage_00272.jpg,240.jpg,RBC,261,191,398,315,1,137,124,329,253,0.5140625,0.5270833333333333,0.2140625,0.25833333333333336
BloodImage_00272.jpg,240.jpg,RBC,449,67,546,161,1,97,94,497,114,0.7765625,0.2375,0.1515625,0.19583333333333333
BloodImage_00272.jpg,240.jpg,RBC,515,259,612,353,1,97,94,563,306,0.8796875,0.6375,0.1515625,0.19583333333333333
BloodImage_00272.jpg,240.jpg,RBC,251,379,356,477,1,105,98,303,428,0.4734375,0.8916666666666667,0.1640625,0.20416666666666666
BloodImage_00272.jpg,240.jpg,RBC,388,347,494,454,1,106,107,441,400,0.6890625,0.8333333333333334,0.165625,0.22291666666666668
BloodImage_00272.jpg,240.jpg,RBC,543,92,634,180,1,91,88,588,136,0.91875,0.2833333333333333,0.1421875,0.18333333333333332
BloodImage_00272.jpg,240.jpg,WBC,1,217,122,408,2,121,191,61,312,0.0953125,0.65,0.1890625,0.39791666666666664
BloodImage_00273.jpg,241.jpg,RBC,227,265,329,359,1,102,94,278,312,0.434375,0.65,0.159375,0.19583333333333333
BloodImage_00273.jpg,241.jpg,RBC,48,211,159,306,1,111,95,103,258,0.1609375,0.5375,0.1734375,0.19791666666666666
BloodImage_00273.jpg,241.jpg,RBC,136,167,271,282,1,135,115,203,224,0.3171875,0.4666666666666667,0.2109375,0.23958333333333334
BloodImage_00273.jpg,241.jpg,RBC,388,275,500,386,1,112,111,444,330,0.69375,0.6875,0.175,0.23125
BloodImage_00273.jpg,241.jpg,RBC,491,286,606,387,1,115,101,548,336,0.85625,0.7,0.1796875,0.21041666666666667
BloodImage_00273.jpg,241.jpg,RBC,342,92,448,188,1,106,96,395,140,0.6171875,0.2916666666666667,0.165625,0.2
BloodImage_00273.jpg,241.jpg,RBC,427,78,533,174,1,106,96,480,126,0.75,0.2625,0.165625,0.2
BloodImage_00273.jpg,241.jpg,RBC,425,170,531,266,1,106,96,478,218,0.746875,0.45416666666666666,0.165625,0.2
BloodImage_00273.jpg,241.jpg,RBC,123,78,229,174,1,106,96,176,126,0.275,0.2625,0.165625,0.2
BloodImage_00273.jpg,241.jpg,RBC,30,61,138,166,1,108,105,84,113,0.13125,0.23541666666666666,0.16875,0.21875
BloodImage_00273.jpg,241.jpg,RBC,555,31,640,129,1,85,98,597,80,0.9328125,0.16666666666666666,0.1328125,0.20416666666666666
BloodImage_00273.jpg,241.jpg,RBC,247,386,346,475,1,99,89,296,430,0.4625,0.8958333333333334,0.1546875,0.18541666666666667
BloodImage_00273.jpg,241.jpg,WBC,193,1,408,123,2,215,122,300,62,0.46875,0.12916666666666668,0.3359375,0.25416666666666665
BloodImage_00273.jpg,241.jpg,Platelets,15,53,49,92,0,34,39,32,72,0.05,0.15,0.053125,0.08125
BloodImage_00273.jpg,241.jpg,Platelets,487,406,526,439,0,39,33,506,422,0.790625,0.8791666666666667,0.0609375,0.06875
BloodImage_00274.jpg,242.jpg,RBC,18,350,124,456,1,106,106,71,403,0.1109375,0.8395833333333333,0.165625,0.22083333333333333
BloodImage_00274.jpg,242.jpg,RBC,511,209,617,315,1,106,106,564,262,0.88125,0.5458333333333333,0.165625,0.22083333333333333
BloodImage_00274.jpg,242.jpg,RBC,518,317,624,423,1,106,106,571,370,0.8921875,0.7708333333333334,0.165625,0.22083333333333333
BloodImage_00274.jpg,242.jpg,RBC,385,43,491,149,1,106,106,438,96,0.684375,0.2,0.165625,0.22083333333333333
BloodImage_00274.jpg,242.jpg,RBC,303,64,409,170,1,106,106,356,117,0.55625,0.24375,0.165625,0.22083333333333333
BloodImage_00274.jpg,242.jpg,RBC,90,147,196,253,1,106,106,143,200,0.2234375,0.4166666666666667,0.165625,0.22083333333333333
BloodImage_00274.jpg,242.jpg,WBC,188,165,387,366,2,199,201,287,265,0.4484375,0.5520833333333334,0.3109375,0.41875
BloodImage_00274.jpg,242.jpg,Platelets,513,298,549,330,0,36,32,531,314,0.8296875,0.6541666666666667,0.05625,0.06666666666666667
BloodImage_00275.jpg,243.jpg,RBC,97,59,219,157,1,122,98,158,108,0.246875,0.225,0.190625,0.20416666666666666
BloodImage_00275.jpg,243.jpg,RBC,213,38,319,140,1,106,102,266,89,0.415625,0.18541666666666667,0.165625,0.2125
BloodImage_00275.jpg,243.jpg,RBC,114,254,225,358,1,111,104,169,306,0.2640625,0.6375,0.1734375,0.21666666666666667
BloodImage_00275.jpg,243.jpg,RBC,528,209,635,301,1,107,92,581,255,0.9078125,0.53125,0.1671875,0.19166666666666668
BloodImage_00275.jpg,243.jpg,RBC,309,95,416,187,1,107,92,362,141,0.565625,0.29375,0.1671875,0.19166666666666668
BloodImage_00275.jpg,243.jpg,RBC,343,93,443,173,1,100,80,393,133,0.6140625,0.27708333333333335,0.15625,0.16666666666666666
BloodImage_00275.jpg,243.jpg,RBC,444,55,544,135,1,100,80,494,95,0.771875,0.19791666666666666,0.15625,0.16666666666666666
BloodImage_00275.jpg,243.jpg,RBC,2,187,131,312,1,129,125,66,249,0.103125,0.51875,0.2015625,0.2604166666666667
BloodImage_00275.jpg,243.jpg,RBC,96,362,201,467,1,105,105,148,414,0.23125,0.8625,0.1640625,0.21875
BloodImage_00275.jpg,243.jpg,RBC,423,309,520,398,1,97,89,471,353,0.7359375,0.7354166666666667,0.1515625,0.18541666666666667
BloodImage_00275.jpg,243.jpg,RBC,491,368,613,480,1,122,112,552,424,0.8625,0.8833333333333333,0.190625,0.23333333333333334
BloodImage_00275.jpg,243.jpg,RBC,181,134,299,231,1,118,97,240,182,0.375,0.37916666666666665,0.184375,0.20208333333333334
BloodImage_00275.jpg,243.jpg,RBC,289,353,401,452,1,112,99,345,402,0.5390625,0.8375,0.175,0.20625
BloodImage_00275.jpg,243.jpg,RBC,1,24,83,135,1,82,111,42,79,0.065625,0.16458333333333333,0.128125,0.23125
BloodImage_00275.jpg,243.jpg,WBC,270,192,416,326,2,146,134,343,259,0.5359375,0.5395833333333333,0.228125,0.2791666666666667
BloodImage_00275.jpg,243.jpg,Platelets,81,168,126,204,0,45,36,103,186,0.1609375,0.3875,0.0703125,0.075
BloodImage_00276.jpg,244.jpg,RBC,143,95,243,213,1,100,118,193,154,0.3015625,0.32083333333333336,0.15625,0.24583333333333332
BloodImage_00276.jpg,244.jpg,RBC,173,194,265,304,1,92,110,219,249,0.3421875,0.51875,0.14375,0.22916666666666666
BloodImage_00276.jpg,244.jpg,RBC,71,11,166,113,1,95,102,118,62,0.184375,0.12916666666666668,0.1484375,0.2125
BloodImage_00276.jpg,244.jpg,RBC,431,32,526,134,1,95,102,478,83,0.746875,0.17291666666666666,0.1484375,0.2125
BloodImage_00276.jpg,244.jpg,RBC,490,32,585,134,1,95,102,537,83,0.8390625,0.17291666666666666,0.1484375,0.2125
BloodImage_00276.jpg,244.jpg,RBC,440,144,535,246,1,95,102,487,195,0.7609375,0.40625,0.1484375,0.2125
BloodImage_00276.jpg,244.jpg,RBC,527,161,622,263,1,95,102,574,212,0.896875,0.44166666666666665,0.1484375,0.2125
BloodImage_00276.jpg,244.jpg,RBC,417,246,524,354,1,107,108,470,300,0.734375,0.625,0.1671875,0.225
BloodImage_00276.jpg,244.jpg,RBC,378,302,485,410,1,107,108,431,356,0.6734375,0.7416666666666667,0.1671875,0.225
BloodImage_00276.jpg,244.jpg,RBC,46,207,137,309,1,91,102,91,258,0.1421875,0.5375,0.1421875,0.2125
BloodImage_00276.jpg,244.jpg,RBC,54,360,165,466,1,111,106,109,413,0.1703125,0.8604166666666667,0.1734375,0.22083333333333333
BloodImage_00276.jpg,244.jpg,RBC,512,327,614,419,1,102,92,563,373,0.8796875,0.7770833333333333,0.159375,0.19166666666666668
BloodImage_00276.jpg,244.jpg,WBC,221,36,415,225,2,194,189,318,130,0.496875,0.2708333333333333,0.303125,0.39375
BloodImage_00276.jpg,244.jpg,Platelets,351,317,382,349,0,31,32,366,333,0.571875,0.69375,0.0484375,0.06666666666666667
BloodImage_00276.jpg,244.jpg,Platelets,37,166,72,203,0,35,37,54,184,0.084375,0.38333333333333336,0.0546875,0.07708333333333334
BloodImage_00277.jpg,245.jpg,RBC,74,301,179,404,1,105,103,126,352,0.196875,0.7333333333333333,0.1640625,0.21458333333333332
BloodImage_00277.jpg,245.jpg,RBC,204,332,283,402,1,79,70,243,367,0.3796875,0.7645833333333333,0.1234375,0.14583333333333334
BloodImage_00277.jpg,245.jpg,RBC,1,259,69,369,1,68,110,35,314,0.0546875,0.6541666666666667,0.10625,0.22916666666666666
BloodImage_00277.jpg,245.jpg,RBC,215,134,308,215,1,93,81,261,174,0.4078125,0.3625,0.1453125,0.16875
BloodImage_00277.jpg,245.jpg,RBC,364,1,472,83,1,108,82,418,42,0.653125,0.0875,0.16875,0.17083333333333334
BloodImage_00277.jpg,245.jpg,RBC,108,77,210,184,1,102,107,159,130,0.2484375,0.2708333333333333,0.159375,0.22291666666666668
BloodImage_00277.jpg,245.jpg,RBC,472,1,610,95,1,138,94,541,48,0.8453125,0.1,0.215625,0.19583333333333333
BloodImage_00277.jpg,245.jpg,RBC,506,359,606,462,1,100,103,556,410,0.86875,0.8541666666666666,0.15625,0.21458333333333332
BloodImage_00277.jpg,245.jpg,RBC,558,216,640,340,1,82,124,599,278,0.9359375,0.5791666666666667,0.128125,0.25833333333333336
BloodImage_00277.jpg,245.jpg,RBC,225,404,313,480,1,88,76,269,442,0.4203125,0.9208333333333333,0.1375,0.15833333333333333
BloodImage_00277.jpg,245.jpg,RBC,532,108,640,213,1,108,105,586,160,0.915625,0.3333333333333333,0.16875,0.21875
BloodImage_00277.jpg,245.jpg,RBC,137,1,262,98,1,125,97,199,49,0.3109375,0.10208333333333333,0.1953125,0.20208333333333334
BloodImage_00277.jpg,245.jpg,RBC,361,348,486,446,1,125,98,423,397,0.6609375,0.8270833333333333,0.1953125,0.20416666666666666
BloodImage_00277.jpg,245.jpg,Platelets,66,424,110,468,0,44,44,88,446,0.1375,0.9291666666666667,0.06875,0.09166666666666666
BloodImage_00277.jpg,245.jpg,WBC,337,185,492,372,2,155,187,414,278,0.646875,0.5791666666666667,0.2421875,0.38958333333333334
BloodImage_00277.jpg,245.jpg,Platelets,51,176,100,211,0,49,35,75,193,0.1171875,0.40208333333333335,0.0765625,0.07291666666666667
BloodImage_00278.jpg,246.jpg,RBC,3,346,123,464,1,120,118,63,405,0.0984375,0.84375,0.1875,0.24583333333333332
BloodImage_00278.jpg,246.jpg,RBC,165,153,285,271,1,120,118,225,212,0.3515625,0.44166666666666665,0.1875,0.24583333333333332
BloodImage_00278.jpg,246.jpg,RBC,359,1,476,104,1,117,103,417,52,0.6515625,0.10833333333333334,0.1828125,0.21458333333333332
BloodImage_00278.jpg,246.jpg,RBC,270,93,387,197,1,117,104,328,145,0.5125,0.3020833333333333,0.1828125,0.21666666666666667
BloodImage_00278.jpg,246.jpg,RBC,389,175,500,313,1,111,138,444,244,0.69375,0.5083333333333333,0.1734375,0.2875
BloodImage_00278.jpg,246.jpg,RBC,559,51,640,168,1,81,117,599,109,0.9359375,0.22708333333333333,0.1265625,0.24375
BloodImage_00278.jpg,246.jpg,RBC,492,423,610,479,1,118,56,551,451,0.8609375,0.9395833333333333,0.184375,0.11666666666666667
BloodImage_00278.jpg,246.jpg,RBC,31,177,151,295,1,120,118,91,236,0.1421875,0.49166666666666664,0.1875,0.24583333333333332
BloodImage_00278.jpg,246.jpg,RBC,149,43,256,132,1,107,89,202,87,0.315625,0.18125,0.1671875,0.18541666666666667
BloodImage_00278.jpg,246.jpg,RBC,246,433,353,480,1,107,47,299,456,0.4671875,0.95,0.1671875,0.09791666666666667
BloodImage_00278.jpg,246.jpg,RBC,394,114,525,217,1,131,103,459,165,0.7171875,0.34375,0.2046875,0.21458333333333332
BloodImage_00278.jpg,246.jpg,RBC,469,211,577,329,1,108,118,523,270,0.8171875,0.5625,0.16875,0.24583333333333332
BloodImage_00278.jpg,246.jpg,Platelets,295,338,325,369,0,30,31,310,353,0.484375,0.7354166666666667,0.046875,0.06458333333333334
BloodImage_00278.jpg,246.jpg,Platelets,79,48,115,90,0,36,42,97,69,0.1515625,0.14375,0.05625,0.0875
BloodImage_00278.jpg,246.jpg,WBC,318,318,487,480,2,169,162,402,399,0.628125,0.83125,0.2640625,0.3375
BloodImage_00279.jpg,247.jpg,RBC,287,293,394,395,1,107,102,340,344,0.53125,0.7166666666666667,0.1671875,0.2125
BloodImage_00279.jpg,247.jpg,RBC,214,281,302,365,1,88,84,258,323,0.403125,0.6729166666666667,0.1375,0.175
BloodImage_00279.jpg,247.jpg,RBC,44,49,131,173,1,87,124,87,111,0.1359375,0.23125,0.1359375,0.25833333333333336
BloodImage_00279.jpg,247.jpg,RBC,522,122,629,224,1,107,102,575,173,0.8984375,0.36041666666666666,0.1671875,0.2125
BloodImage_00279.jpg,247.jpg,RBC,161,163,270,267,1,109,104,215,215,0.3359375,0.4479166666666667,0.1703125,0.21666666666666667
BloodImage_00279.jpg,247.jpg,RBC,246,171,343,268,1,97,97,294,219,0.459375,0.45625,0.1515625,0.20208333333333334
BloodImage_00279.jpg,247.jpg,RBC,305,178,404,270,1,99,92,354,224,0.553125,0.4666666666666667,0.1546875,0.19166666666666668
BloodImage_00279.jpg,247.jpg,RBC,158,370,257,462,1,99,92,207,416,0.3234375,0.8666666666666667,0.1546875,0.19166666666666668
BloodImage_00279.jpg,247.jpg,RBC,1,195,70,296,1,69,101,35,245,0.0546875,0.5104166666666666,0.1078125,0.21041666666666667
BloodImage_00279.jpg,247.jpg,RBC,134,279,233,371,1,99,92,183,325,0.2859375,0.6770833333333334,0.1546875,0.19166666666666668
BloodImage_00279.jpg,247.jpg,RBC,437,119,531,223,1,94,104,484,171,0.75625,0.35625,0.146875,0.21666666666666667
BloodImage_00279.jpg,247.jpg,RBC,458,237,576,346,1,118,109,517,291,0.8078125,0.60625,0.184375,0.22708333333333333
BloodImage_00279.jpg,247.jpg,RBC,419,331,537,440,1,118,109,478,385,0.746875,0.8020833333333334,0.184375,0.22708333333333333
BloodImage_00279.jpg,247.jpg,WBC,244,1,483,178,2,239,177,363,89,0.5671875,0.18541666666666667,0.3734375,0.36875
BloodImage_00281.jpg,248.jpg,RBC,112,140,221,242,1,109,102,166,191,0.259375,0.39791666666666664,0.1703125,0.2125
BloodImage_00281.jpg,248.jpg,RBC,79,45,176,148,1,97,103,127,96,0.1984375,0.2,0.1515625,0.21458333333333332
BloodImage_00281.jpg,248.jpg,RBC,1,254,112,366,1,111,112,56,310,0.0875,0.6458333333333334,0.1734375,0.23333333333333334
BloodImage_00281.jpg,248.jpg,RBC,111,345,222,454,1,111,109,166,399,0.259375,0.83125,0.1734375,0.22708333333333333
BloodImage_00281.jpg,248.jpg,RBC,120,258,238,363,1,118,105,179,310,0.2796875,0.6458333333333334,0.184375,0.21875
BloodImage_00281.jpg,248.jpg,RBC,232,52,349,186,1,117,134,290,119,0.453125,0.24791666666666667,0.1828125,0.2791666666666667
BloodImage_00281.jpg,248.jpg,RBC,413,121,531,226,1,118,105,472,173,0.7375,0.36041666666666666,0.184375,0.21875
BloodImage_00281.jpg,248.jpg,RBC,529,265,640,373,1,111,108,584,319,0.9125,0.6645833333333333,0.1734375,0.225
BloodImage_00281.jpg,248.jpg,RBC,1,1,126,100,1,125,99,63,50,0.0984375,0.10416666666666667,0.1953125,0.20625
BloodImage_00281.jpg,248.jpg,RBC,522,73,617,197,1,95,124,569,135,0.8890625,0.28125,0.1484375,0.25833333333333336
BloodImage_00281.jpg,248.jpg,WBC,216,152,471,387,2,255,235,343,269,0.5359375,0.5604166666666667,0.3984375,0.4895833333333333
BloodImage_00282.jpg,249.jpg,RBC,322,250,460,357,1,138,107,391,303,0.6109375,0.63125,0.215625,0.22291666666666668
BloodImage_00282.jpg,249.jpg,RBC,1,234,119,342,1,118,108,60,288,0.09375,0.6,0.184375,0.225
BloodImage_00282.jpg,249.jpg,RBC,26,106,142,220,1,116,114,84,163,0.13125,0.33958333333333335,0.18125,0.2375
BloodImage_00282.jpg,249.jpg,RBC,4,1,114,93,1,110,92,59,47,0.0921875,0.09791666666666667,0.171875,0.19166666666666668
BloodImage_00282.jpg,249.jpg,RBC,154,104,264,197,1,110,93,209,150,0.3265625,0.3125,0.171875,0.19375
BloodImage_00282.jpg,249.jpg,RBC,132,204,237,297,1,105,93,184,250,0.2875,0.5208333333333334,0.1640625,0.19375
BloodImage_00282.jpg,249.jpg,RBC,268,137,356,266,1,88,129,312,201,0.4875,0.41875,0.1375,0.26875
BloodImage_00282.jpg,249.jpg,RBC,277,377,381,477,1,104,100,329,427,0.5140625,0.8895833333333333,0.1625,0.20833333333333334
BloodImage_00282.jpg,249.jpg,RBC,78,341,203,450,1,125,109,140,395,0.21875,0.8229166666666666,0.1953125,0.22708333333333333
BloodImage_00282.jpg,249.jpg,RBC,537,202,640,315,1,103,113,588,258,0.91875,0.5375,0.1609375,0.23541666666666666
BloodImage_00282.jpg,249.jpg,RBC,537,96,640,208,1,103,112,588,152,0.91875,0.31666666666666665,0.1609375,0.23333333333333334
BloodImage_00282.jpg,249.jpg,RBC,423,311,526,423,1,103,112,474,367,0.740625,0.7645833333333333,0.1609375,0.23333333333333334
BloodImage_00282.jpg,249.jpg,RBC,218,265,321,377,1,103,112,269,321,0.4203125,0.66875,0.1609375,0.23333333333333334
BloodImage_00282.jpg,249.jpg,RBC,500,1,624,60,1,124,59,562,30,0.878125,0.0625,0.19375,0.12291666666666666
BloodImage_00282.jpg,249.jpg,WBC,142,1,369,126,2,227,125,255,63,0.3984375,0.13125,0.3546875,0.2604166666666667
BloodImage_00283.jpg,250.jpg,RBC,381,274,494,367,1,113,93,437,320,0.6828125,0.6666666666666666,0.1765625,0.19375
BloodImage_00283.jpg,250.jpg,RBC,435,156,554,274,1,119,118,494,215,0.771875,0.4479166666666667,0.1859375,0.24583333333333332
BloodImage_00283.jpg,250.jpg,RBC,347,96,455,204,1,108,108,401,150,0.6265625,0.3125,0.16875,0.225
BloodImage_00283.jpg,250.jpg,RBC,282,150,386,243,1,104,93,334,196,0.521875,0.4083333333333333,0.1625,0.19375
BloodImage_00283.jpg,250.jpg,RBC,343,1,447,93,1,104,92,395,47,0.6171875,0.09791666666666667,0.1625,0.19166666666666668
BloodImage_00283.jpg,250.jpg,RBC,355,379,466,480,1,111,101,410,429,0.640625,0.89375,0.1734375,0.21041666666666667
BloodImage_00283.jpg,250.jpg,RBC,220,407,330,480,1,110,73,275,443,0.4296875,0.9229166666666667,0.171875,0.15208333333333332
BloodImage_00283.jpg,250.jpg,RBC,448,1,560,107,1,112,106,504,54,0.7875,0.1125,0.175,0.22083333333333333
BloodImage_00283.jpg,250.jpg,RBC,547,334,640,442,1,93,108,593,388,0.9265625,0.8083333333333333,0.1453125,0.225
BloodImage_00283.jpg,250.jpg,RBC,173,63,266,171,1,93,108,219,117,0.3421875,0.24375,0.1453125,0.225
BloodImage_00283.jpg,250.jpg,RBC,54,73,147,181,1,93,108,100,127,0.15625,0.26458333333333334,0.1453125,0.225
BloodImage_00283.jpg,250.jpg,RBC,10,126,103,234,1,93,108,56,180,0.0875,0.375,0.1453125,0.225
BloodImage_00283.jpg,250.jpg,WBC,28,223,255,407,2,227,184,141,315,0.2203125,0.65625,0.3546875,0.38333333333333336
BloodImage_00284.jpg,251.jpg,RBC,227,85,328,209,1,101,124,277,147,0.4328125,0.30625,0.1578125,0.25833333333333336
BloodImage_00284.jpg,251.jpg,RBC,225,83,326,207,1,101,124,275,145,0.4296875,0.3020833333333333,0.1578125,0.25833333333333336
BloodImage_00284.jpg,251.jpg,RBC,366,1,466,96,1,100,95,416,48,0.65,0.1,0.15625,0.19791666666666666
BloodImage_00284.jpg,251.jpg,RBC,343,136,443,232,1,100,96,393,184,0.6140625,0.38333333333333336,0.15625,0.2
BloodImage_00284.jpg,251.jpg,RBC,166,195,286,291,1,120,96,226,243,0.353125,0.50625,0.1875,0.2
BloodImage_00284.jpg,251.jpg,RBC,98,297,221,418,1,123,121,159,357,0.2484375,0.74375,0.1921875,0.2520833333333333
BloodImage_00284.jpg,251.jpg,RBC,436,83,559,204,1,123,121,497,143,0.7765625,0.29791666666666666,0.1921875,0.2520833333333333
BloodImage_00284.jpg,251.jpg,RBC,457,283,563,394,1,106,111,510,338,0.796875,0.7041666666666667,0.165625,0.23125
BloodImage_00284.jpg,251.jpg,RBC,552,336,640,429,1,88,93,596,382,0.93125,0.7958333333333333,0.1375,0.19375
BloodImage_00284.jpg,251.jpg,RBC,1,250,94,371,1,93,121,47,310,0.0734375,0.6458333333333334,0.1453125,0.2520833333333333
BloodImage_00284.jpg,251.jpg,WBC,216,209,517,480,2,301,271,366,344,0.571875,0.7166666666666667,0.4703125,0.5645833333333333
BloodImage_00285.jpg,252.jpg,RBC,16,152,107,252,1,91,100,61,202,0.0953125,0.42083333333333334,0.1421875,0.20833333333333334
BloodImage_00285.jpg,252.jpg,RBC,18,261,119,363,1,101,102,68,312,0.10625,0.65,0.1578125,0.2125
BloodImage_00285.jpg,252.jpg,RBC,40,369,137,479,1,97,110,88,424,0.1375,0.8833333333333333,0.1515625,0.22916666666666666
BloodImage_00285.jpg,252.jpg,RBC,203,70,324,171,1,121,101,263,120,0.4109375,0.25,0.1890625,0.21041666666666667
BloodImage_00285.jpg,252.jpg,RBC,87,113,208,214,1,121,101,147,163,0.2296875,0.33958333333333335,0.1890625,0.21041666666666667
BloodImage_00285.jpg,252.jpg,RBC,112,1,233,101,1,121,100,172,51,0.26875,0.10625,0.1890625,0.20833333333333334
BloodImage_00285.jpg,252.jpg,RBC,340,50,461,151,1,121,101,400,100,0.625,0.20833333333333334,0.1890625,0.21041666666666667
BloodImage_00285.jpg,252.jpg,RBC,427,214,548,316,1,121,102,487,265,0.7609375,0.5520833333333334,0.1890625,0.2125
BloodImage_00285.jpg,252.jpg,RBC,424,314,545,416,1,121,102,484,365,0.75625,0.7604166666666666,0.1890625,0.2125
BloodImage_00285.jpg,252.jpg,RBC,530,381,640,480,1,110,99,585,430,0.9140625,0.8958333333333334,0.171875,0.20625
BloodImage_00285.jpg,252.jpg,RBC,455,101,583,225,1,128,124,519,163,0.8109375,0.33958333333333335,0.2,0.25833333333333336
BloodImage_00285.jpg,252.jpg,Platelets,115,245,154,279,0,39,34,134,262,0.209375,0.5458333333333333,0.0609375,0.07083333333333333
BloodImage_00285.jpg,252.jpg,WBC,181,254,400,468,2,219,214,290,361,0.453125,0.7520833333333333,0.3421875,0.44583333333333336
BloodImage_00287.jpg,253.jpg,RBC,185,297,321,404,1,136,107,253,350,0.3953125,0.7291666666666666,0.2125,0.22291666666666668
BloodImage_00287.jpg,253.jpg,RBC,305,370,396,472,1,91,102,350,421,0.546875,0.8770833333333333,0.1421875,0.2125
BloodImage_00287.jpg,253.jpg,RBC,477,354,582,459,1,105,105,529,406,0.8265625,0.8458333333333333,0.1640625,0.21875
BloodImage_00287.jpg,253.jpg,RBC,376,307,481,412,1,105,105,428,359,0.66875,0.7479166666666667,0.1640625,0.21875
BloodImage_00287.jpg,253.jpg,RBC,392,208,497,313,1,105,105,444,260,0.69375,0.5416666666666666,0.1640625,0.21875
BloodImage_00287.jpg,253.jpg,RBC,302,44,420,151,1,118,107,361,97,0.5640625,0.20208333333333334,0.184375,0.22291666666666668
BloodImage_00287.jpg,253.jpg,RBC,185,108,303,231,1,118,123,244,169,0.38125,0.35208333333333336,0.184375,0.25625
BloodImage_00287.jpg,253.jpg,RBC,373,133,487,243,1,114,110,430,188,0.671875,0.39166666666666666,0.178125,0.22916666666666666
BloodImage_00287.jpg,253.jpg,RBC,177,1,298,109,1,121,108,237,55,0.3703125,0.11458333333333333,0.1890625,0.225
BloodImage_00287.jpg,253.jpg,RBC,52,22,184,88,1,132,66,118,55,0.184375,0.11458333333333333,0.20625,0.1375
BloodImage_00287.jpg,253.jpg,RBC,530,65,640,147,1,110,82,585,106,0.9140625,0.22083333333333333,0.171875,0.17083333333333334
BloodImage_00287.jpg,253.jpg,RBC,543,116,640,214,1,97,98,591,165,0.9234375,0.34375,0.1515625,0.20416666666666666
BloodImage_00287.jpg,253.jpg,RBC,501,1,596,67,1,95,66,548,34,0.85625,0.07083333333333333,0.1484375,0.1375
BloodImage_00287.jpg,253.jpg,RBC,374,1,469,67,1,95,66,421,34,0.6578125,0.07083333333333333,0.1484375,0.1375
BloodImage_00287.jpg,253.jpg,WBC,1,163,192,366,2,191,203,96,264,0.15,0.55,0.2984375,0.42291666666666666
BloodImage_00287.jpg,253.jpg,Platelets,161,320,205,364,0,44,44,183,342,0.2859375,0.7125,0.06875,0.09166666666666666
BloodImage_00288.jpg,254.jpg,RBC,67,359,163,452,1,96,93,115,405,0.1796875,0.84375,0.15,0.19375
BloodImage_00288.jpg,254.jpg,RBC,339,387,435,480,1,96,93,387,433,0.6046875,0.9020833333333333,0.15,0.19375
BloodImage_00288.jpg,254.jpg,RBC,407,328,520,422,1,113,94,463,375,0.7234375,0.78125,0.1765625,0.19583333333333333
BloodImage_00288.jpg,254.jpg,RBC,444,229,544,321,1,100,92,494,275,0.771875,0.5729166666666666,0.15625,0.19166666666666668
BloodImage_00288.jpg,254.jpg,RBC,420,126,522,223,1,102,97,471,174,0.7359375,0.3625,0.159375,0.20208333333333334
BloodImage_00288.jpg,254.jpg,RBC,352,202,440,302,1,88,100,396,252,0.61875,0.525,0.1375,0.20833333333333334
BloodImage_00288.jpg,254.jpg,RBC,119,104,228,199,1,109,95,173,151,0.2703125,0.3145833333333333,0.1703125,0.19791666666666666
BloodImage_00288.jpg,254.jpg,RBC,287,74,402,188,1,115,114,344,131,0.5375,0.27291666666666664,0.1796875,0.2375
BloodImage_00288.jpg,254.jpg,RBC,47,12,158,123,1,111,111,102,67,0.159375,0.13958333333333334,0.1734375,0.23125
BloodImage_00288.jpg,254.jpg,RBC,185,1,308,111,1,123,110,246,56,0.384375,0.11666666666666667,0.1921875,0.22916666666666666
BloodImage_00288.jpg,254.jpg,RBC,43,179,152,274,1,109,95,97,226,0.1515625,0.4708333333333333,0.1703125,0.19791666666666666
BloodImage_00288.jpg,254.jpg,RBC,1,218,109,313,1,108,95,55,265,0.0859375,0.5520833333333334,0.16875,0.19791666666666666
BloodImage_00288.jpg,254.jpg,RBC,208,166,321,270,1,113,104,264,218,0.4125,0.45416666666666666,0.1765625,0.21666666666666667
BloodImage_00288.jpg,254.jpg,RBC,479,21,594,135,1,115,114,536,78,0.8375,0.1625,0.1796875,0.2375
BloodImage_00288.jpg,254.jpg,RBC,529,147,634,254,1,105,107,581,200,0.9078125,0.4166666666666667,0.1640625,0.22291666666666668
BloodImage_00288.jpg,254.jpg,RBC,525,373,630,480,1,105,107,577,426,0.9015625,0.8875,0.1640625,0.22291666666666668
BloodImage_00288.jpg,254.jpg,RBC,552,251,640,352,1,88,101,596,301,0.93125,0.6270833333333333,0.1375,0.21041666666666667
BloodImage_00288.jpg,254.jpg,RBC,305,1,407,79,1,102,78,356,40,0.55625,0.08333333333333333,0.159375,0.1625
BloodImage_00288.jpg,254.jpg,WBC,153,263,370,474,2,217,211,261,368,0.4078125,0.7666666666666667,0.3390625,0.4395833333333333
BloodImage_00289.jpg,255.jpg,RBC,180,281,273,386,1,93,105,226,333,0.353125,0.69375,0.1453125,0.21875
BloodImage_00289.jpg,255.jpg,RBC,246,343,339,448,1,93,105,292,395,0.45625,0.8229166666666666,0.1453125,0.21875
BloodImage_00289.jpg,255.jpg,RBC,432,257,551,361,1,119,104,491,309,0.7671875,0.64375,0.1859375,0.21666666666666667
BloodImage_00289.jpg,255.jpg,RBC,521,203,640,307,1,119,104,580,255,0.90625,0.53125,0.1859375,0.21666666666666667
BloodImage_00289.jpg,255.jpg,RBC,535,101,640,206,1,105,105,587,153,0.9171875,0.31875,0.1640625,0.21875
BloodImage_00289.jpg,255.jpg,RBC,332,279,443,402,1,111,123,387,340,0.6046875,0.7083333333333334,0.1734375,0.25625
BloodImage_00289.jpg,255.jpg,RBC,162,1,280,102,1,118,101,221,51,0.3453125,0.10625,0.184375,0.21041666666666667
BloodImage_00289.jpg,255.jpg,RBC,55,66,173,168,1,118,102,114,117,0.178125,0.24375,0.184375,0.2125
BloodImage_00289.jpg,255.jpg,RBC,140,163,258,265,1,118,102,199,214,0.3109375,0.44583333333333336,0.184375,0.2125
BloodImage_00289.jpg,255.jpg,RBC,1,270,117,372,1,116,102,59,321,0.0921875,0.66875,0.18125,0.2125
BloodImage_00289.jpg,255.jpg,WBC,251,55,482,288,2,231,233,366,171,0.571875,0.35625,0.3609375,0.48541666666666666
BloodImage_00290.jpg,256.jpg,RBC,222,343,332,442,1,110,99,277,392,0.4328125,0.8166666666666667,0.171875,0.20625
BloodImage_00290.jpg,256.jpg,RBC,329,360,439,459,1,110,99,384,409,0.6,0.8520833333333333,0.171875,0.20625
BloodImage_00290.jpg,256.jpg,RBC,450,366,560,465,1,110,99,505,415,0.7890625,0.8645833333333334,0.171875,0.20625
BloodImage_00290.jpg,256.jpg,RBC,524,259,640,373,1,116,114,582,316,0.909375,0.6583333333333333,0.18125,0.2375
BloodImage_00290.jpg,256.jpg,RBC,492,1,607,93,1,115,92,549,47,0.8578125,0.09791666666666667,0.1796875,0.19166666666666668
BloodImage_00290.jpg,256.jpg,RBC,342,100,458,217,1,116,117,400,158,0.625,0.32916666666666666,0.18125,0.24375
BloodImage_00290.jpg,256.jpg,RBC,395,14,504,124,1,109,110,449,69,0.7015625,0.14375,0.1703125,0.22916666666666666
BloodImage_00290.jpg,256.jpg,RBC,1,331,66,446,1,65,115,33,388,0.0515625,0.8083333333333333,0.1015625,0.23958333333333334
BloodImage_00290.jpg,256.jpg,RBC,1,129,94,231,1,93,102,47,180,0.0734375,0.375,0.1453125,0.2125
BloodImage_00290.jpg,256.jpg,RBC,395,185,489,287,1,94,102,442,236,0.690625,0.49166666666666664,0.146875,0.2125
BloodImage_00290.jpg,256.jpg,RBC,476,69,598,167,1,122,98,537,118,0.8390625,0.24583333333333332,0.190625,0.20416666666666666
BloodImage_00290.jpg,256.jpg,WBC,126,113,387,295,2,261,182,256,204,0.4,0.425,0.4078125,0.37916666666666665
BloodImage_00291.jpg,257.jpg,RBC,446,143,530,255,1,84,112,488,199,0.7625,0.41458333333333336,0.13125,0.23333333333333334
BloodImage_00291.jpg,257.jpg,RBC,444,287,528,399,1,84,112,486,343,0.759375,0.7145833333333333,0.13125,0.23333333333333334
BloodImage_00291.jpg,257.jpg,RBC,544,80,628,192,1,84,112,586,136,0.915625,0.2833333333333333,0.13125,0.23333333333333334
BloodImage_00291.jpg,257.jpg,RBC,445,1,543,113,1,98,112,494,57,0.771875,0.11875,0.153125,0.23333333333333334
BloodImage_00291.jpg,257.jpg,RBC,186,39,303,129,1,117,90,244,84,0.38125,0.175,0.1828125,0.1875
BloodImage_00291.jpg,257.jpg,RBC,71,369,183,463,1,112,94,127,416,0.1984375,0.8666666666666667,0.175,0.19583333333333333
BloodImage_00291.jpg,257.jpg,RBC,17,115,152,198,1,135,83,84,156,0.13125,0.325,0.2109375,0.17291666666666666
BloodImage_00291.jpg,257.jpg,RBC,336,102,436,214,1,100,112,386,158,0.603125,0.32916666666666666,0.15625,0.23333333333333334
BloodImage_00291.jpg,257.jpg,RBC,348,180,457,277,1,109,97,402,228,0.628125,0.475,0.1703125,0.20208333333333334
BloodImage_00291.jpg,257.jpg,WBC,185,213,441,436,2,256,223,313,324,0.4890625,0.675,0.4,0.46458333333333335
BloodImage_00292.jpg,258.jpg,RBC,133,226,235,331,1,102,105,184,278,0.2875,0.5791666666666667,0.159375,0.21875
BloodImage_00292.jpg,258.jpg,RBC,281,240,383,345,1,102,105,332,292,0.51875,0.6083333333333333,0.159375,0.21875
BloodImage_00292.jpg,258.jpg,RBC,307,345,409,450,1,102,105,358,397,0.559375,0.8270833333333333,0.159375,0.21875
BloodImage_00292.jpg,258.jpg,RBC,199,312,294,409,1,95,97,246,360,0.384375,0.75,0.1484375,0.20208333333333334
BloodImage_00292.jpg,258.jpg,RBC,114,366,209,463,1,95,97,161,414,0.2515625,0.8625,0.1484375,0.20208333333333334
BloodImage_00292.jpg,258.jpg,RBC,148,131,243,228,1,95,97,195,179,0.3046875,0.3729166666666667,0.1484375,0.20208333333333334
BloodImage_00292.jpg,258.jpg,RBC,209,46,318,142,1,109,96,263,94,0.4109375,0.19583333333333333,0.1703125,0.2
BloodImage_00292.jpg,258.jpg,RBC,244,146,353,242,1,109,96,298,194,0.465625,0.4041666666666667,0.1703125,0.2
BloodImage_00292.jpg,258.jpg,RBC,506,106,615,221,1,109,115,560,163,0.875,0.33958333333333335,0.1703125,0.23958333333333334
BloodImage_00292.jpg,258.jpg,RBC,508,354,617,469,1,109,115,562,411,0.878125,0.85625,0.1703125,0.23958333333333334
BloodImage_00292.jpg,258.jpg,RBC,409,284,545,393,1,136,109,477,338,0.7453125,0.7041666666666667,0.2125,0.22708333333333333
BloodImage_00292.jpg,258.jpg,RBC,44,78,153,193,1,109,115,98,135,0.153125,0.28125,0.1703125,0.23958333333333334
BloodImage_00292.jpg,258.jpg,RBC,23,181,132,296,1,109,115,77,238,0.1203125,0.49583333333333335,0.1703125,0.23958333333333334
BloodImage_00292.jpg,258.jpg,WBC,314,1,537,130,2,223,129,425,65,0.6640625,0.13541666666666666,0.3484375,0.26875
BloodImage_00293.jpg,259.jpg,RBC,131,358,243,450,1,112,92,187,404,0.2921875,0.8416666666666667,0.175,0.19166666666666668
BloodImage_00293.jpg,259.jpg,RBC,279,64,398,171,1,119,107,338,117,0.528125,0.24375,0.1859375,0.22291666666666668
BloodImage_00293.jpg,259.jpg,RBC,471,3,590,110,1,119,107,530,56,0.828125,0.11666666666666667,0.1859375,0.22291666666666668
BloodImage_00293.jpg,259.jpg,RBC,544,88,640,191,1,96,103,592,139,0.925,0.28958333333333336,0.15,0.21458333333333332
BloodImage_00293.jpg,259.jpg,RBC,465,157,584,264,1,119,107,524,210,0.81875,0.4375,0.1859375,0.22291666666666668
BloodImage_00293.jpg,259.jpg,RBC,69,307,147,438,1,78,131,108,372,0.16875,0.775,0.121875,0.27291666666666664
BloodImage_00293.jpg,259.jpg,RBC,417,373,536,480,1,119,107,476,426,0.74375,0.8875,0.1859375,0.22291666666666668
BloodImage_00293.jpg,259.jpg,RBC,396,265,515,372,1,119,107,455,318,0.7109375,0.6625,0.1859375,0.22291666666666668
BloodImage_00293.jpg,259.jpg,RBC,335,1,450,75,1,115,74,392,38,0.6125,0.07916666666666666,0.1796875,0.15416666666666667
BloodImage_00293.jpg,259.jpg,RBC,40,31,159,138,1,119,107,99,84,0.1546875,0.175,0.1859375,0.22291666666666668
BloodImage_00293.jpg,259.jpg,WBC,123,150,340,358,2,217,208,231,254,0.3609375,0.5291666666666667,0.3390625,0.43333333333333335
BloodImage_00294.jpg,260.jpg,RBC,463,73,558,188,1,95,115,510,130,0.796875,0.2708333333333333,0.1484375,0.23958333333333334
BloodImage_00294.jpg,260.jpg,RBC,292,75,387,190,1,95,115,339,132,0.5296875,0.275,0.1484375,0.23958333333333334
BloodImage_00294.jpg,260.jpg,RBC,202,11,330,115,1,128,104,266,63,0.415625,0.13125,0.2,0.21666666666666667
BloodImage_00294.jpg,260.jpg,RBC,115,18,215,108,1,100,90,165,63,0.2578125,0.13125,0.15625,0.1875
BloodImage_00294.jpg,260.jpg,RBC,71,101,171,191,1,100,90,121,146,0.1890625,0.30416666666666664,0.15625,0.1875
BloodImage_00294.jpg,260.jpg,RBC,162,109,262,199,1,100,90,212,154,0.33125,0.32083333333333336,0.15625,0.1875
BloodImage_00294.jpg,260.jpg,RBC,106,189,209,293,1,103,104,157,241,0.2453125,0.5020833333333333,0.1609375,0.21666666666666667
BloodImage_00294.jpg,260.jpg,RBC,159,348,262,452,1,103,104,210,400,0.328125,0.8333333333333334,0.1609375,0.21666666666666667
BloodImage_00294.jpg,260.jpg,RBC,205,195,308,299,1,103,104,256,247,0.4,0.5145833333333333,0.1609375,0.21666666666666667
BloodImage_00294.jpg,260.jpg,RBC,383,376,543,472,1,160,96,463,424,0.7234375,0.8833333333333333,0.25,0.2
BloodImage_00294.jpg,260.jpg,WBC,334,169,525,384,2,191,215,429,276,0.6703125,0.575,0.2984375,0.4479166666666667
BloodImage_00295.jpg,261.jpg,RBC,20,192,109,296,1,89,104,64,244,0.1,0.5083333333333333,0.1390625,0.21666666666666667
BloodImage_00295.jpg,261.jpg,RBC,314,277,423,371,1,109,94,368,324,0.575,0.675,0.1703125,0.19583333333333333
BloodImage_00295.jpg,261.jpg,RBC,477,196,590,289,1,113,93,533,242,0.8328125,0.5041666666666667,0.1765625,0.19375
BloodImage_00295.jpg,261.jpg,RBC,488,303,601,408,1,113,105,544,355,0.85,0.7395833333333334,0.1765625,0.21875
BloodImage_00295.jpg,261.jpg,RBC,377,82,490,187,1,113,105,433,134,0.6765625,0.2791666666666667,0.1765625,0.21875
BloodImage_00295.jpg,261.jpg,RBC,112,56,207,148,1,95,92,159,102,0.2484375,0.2125,0.1484375,0.19166666666666668
BloodImage_00295.jpg,261.jpg,RBC,164,388,259,480,1,95,92,211,434,0.3296875,0.9041666666666667,0.1484375,0.19166666666666668
BloodImage_00295.jpg,261.jpg,RBC,397,366,492,458,1,95,92,444,412,0.69375,0.8583333333333333,0.1484375,0.19166666666666668
BloodImage_00295.jpg,261.jpg,RBC,233,15,328,107,1,95,92,280,61,0.4375,0.12708333333333333,0.1484375,0.19166666666666668
BloodImage_00295.jpg,261.jpg,RBC,319,249,428,343,1,109,94,373,296,0.5828125,0.6166666666666667,0.1703125,0.19583333333333333
BloodImage_00295.jpg,261.jpg,RBC,41,204,130,308,1,89,104,85,256,0.1328125,0.5333333333333333,0.1390625,0.21666666666666667
BloodImage_00295.jpg,261.jpg,WBC,118,141,372,353,2,254,212,245,247,0.3828125,0.5145833333333333,0.396875,0.44166666666666665
BloodImage_00295.jpg,261.jpg,Platelets,121,359,166,404,0,45,45,143,381,0.2234375,0.79375,0.0703125,0.09375
BloodImage_00296.jpg,262.jpg,RBC,20,255,137,355,1,117,100,78,305,0.121875,0.6354166666666666,0.1828125,0.20833333333333334
BloodImage_00296.jpg,262.jpg,RBC,116,329,223,430,1,107,101,169,379,0.2640625,0.7895833333333333,0.1671875,0.21041666666666667
BloodImage_00296.jpg,262.jpg,RBC,5,361,112,462,1,107,101,58,411,0.090625,0.85625,0.1671875,0.21041666666666667
BloodImage_00296.jpg,262.jpg,RBC,210,255,321,388,1,111,133,265,321,0.4140625,0.66875,0.1734375,0.27708333333333335
BloodImage_00296.jpg,262.jpg,RBC,496,139,603,240,1,107,101,549,189,0.8578125,0.39375,0.1671875,0.21041666666666667
BloodImage_00296.jpg,262.jpg,RBC,551,1,640,101,1,89,100,595,51,0.9296875,0.10625,0.1390625,0.20833333333333334
BloodImage_00296.jpg,262.jpg,RBC,494,245,602,361,1,108,116,548,303,0.85625,0.63125,0.16875,0.24166666666666667
BloodImage_00296.jpg,262.jpg,RBC,543,344,640,467,1,97,123,591,405,0.9234375,0.84375,0.1515625,0.25625
BloodImage_00296.jpg,262.jpg,RBC,1,94,108,210,1,107,116,54,152,0.084375,0.31666666666666665,0.1671875,0.24166666666666667
BloodImage_00296.jpg,262.jpg,RBC,131,1,241,95,1,110,94,186,48,0.290625,0.1,0.171875,0.19583333333333333
BloodImage_00296.jpg,262.jpg,RBC,117,170,226,288,1,109,118,171,229,0.2671875,0.47708333333333336,0.1703125,0.24583333333333332
BloodImage_00296.jpg,262.jpg,RBC,386,318,494,458,1,108,140,440,388,0.6875,0.8083333333333333,0.16875,0.2916666666666667
BloodImage_00296.jpg,262.jpg,WBC,204,12,391,226,2,187,214,297,119,0.4640625,0.24791666666666667,0.2921875,0.44583333333333336
BloodImage_00296.jpg,262.jpg,Platelets,349,194,400,246,0,51,52,374,220,0.584375,0.4583333333333333,0.0796875,0.10833333333333334
BloodImage_00296.jpg,262.jpg,Platelets,355,350,394,385,0,39,35,374,367,0.584375,0.7645833333333333,0.0609375,0.07291666666666667
BloodImage_00296.jpg,262.jpg,Platelets,454,451,494,480,0,40,29,474,465,0.740625,0.96875,0.0625,0.06041666666666667
BloodImage_00297.jpg,263.jpg,RBC,400,263,511,350,1,111,87,455,306,0.7109375,0.6375,0.1734375,0.18125
BloodImage_00297.jpg,263.jpg,RBC,393,346,504,433,1,111,87,448,389,0.7,0.8104166666666667,0.1734375,0.18125
BloodImage_00297.jpg,263.jpg,RBC,332,45,440,153,1,108,108,386,99,0.603125,0.20625,0.16875,0.225
BloodImage_00297.jpg,263.jpg,RBC,148,17,256,125,1,108,108,202,71,0.315625,0.14791666666666667,0.16875,0.225
BloodImage_00297.jpg,263.jpg,RBC,54,361,146,450,1,92,89,100,405,0.15625,0.84375,0.14375,0.18541666666666667
BloodImage_00297.jpg,263.jpg,RBC,43,205,127,311,1,84,106,85,258,0.1328125,0.5375,0.13125,0.22083333333333333
BloodImage_00297.jpg,263.jpg,RBC,325,153,438,266,1,113,113,381,209,0.5953125,0.4354166666666667,0.1765625,0.23541666666666666
BloodImage_00297.jpg,263.jpg,RBC,468,156,581,269,1,113,113,524,212,0.81875,0.44166666666666665,0.1765625,0.23541666666666666
BloodImage_00297.jpg,263.jpg,RBC,104,289,196,378,1,92,89,150,333,0.234375,0.69375,0.14375,0.18541666666666667
BloodImage_00297.jpg,263.jpg,WBC,172,275,407,480,2,235,205,289,377,0.4515625,0.7854166666666667,0.3671875,0.4270833333333333
BloodImage_00297.jpg,263.jpg,Platelets,198,235,267,293,0,69,58,232,264,0.3625,0.55,0.1078125,0.12083333333333333
BloodImage_00297.jpg,263.jpg,Platelets,315,1,357,36,0,42,35,336,18,0.525,0.0375,0.065625,0.07291666666666667
BloodImage_00298.jpg,264.jpg,RBC,405,331,503,429,1,98,98,454,380,0.709375,0.7916666666666666,0.153125,0.20416666666666666
BloodImage_00298.jpg,264.jpg,RBC,352,207,455,312,1,103,105,403,259,0.6296875,0.5395833333333333,0.1609375,0.21875
BloodImage_00298.jpg,264.jpg,RBC,332,90,410,193,1,78,103,371,141,0.5796875,0.29375,0.121875,0.21458333333333332
BloodImage_00298.jpg,264.jpg,RBC,528,156,618,254,1,90,98,573,205,0.8953125,0.4270833333333333,0.140625,0.20416666666666666
BloodImage_00298.jpg,264.jpg,RBC,509,317,599,415,1,90,98,554,366,0.865625,0.7625,0.140625,0.20416666666666666
BloodImage_00298.jpg,264.jpg,RBC,52,395,161,480,1,109,85,106,437,0.165625,0.9104166666666667,0.1703125,0.17708333333333334
BloodImage_00298.jpg,264.jpg,RBC,176,132,277,213,1,101,81,226,172,0.353125,0.35833333333333334,0.1578125,0.16875
BloodImage_00298.jpg,264.jpg,RBC,549,49,640,150,1,91,101,594,99,0.928125,0.20625,0.1421875,0.21041666666666667
BloodImage_00298.jpg,264.jpg,RBC,473,249,576,354,1,103,105,524,301,0.81875,0.6270833333333333,0.1609375,0.21875
BloodImage_00298.jpg,264.jpg,WBC,120,215,315,436,2,195,221,217,325,0.3390625,0.6770833333333334,0.3046875,0.46041666666666664
BloodImage_00299.jpg,265.jpg,RBC,480,301,587,409,1,107,108,533,355,0.8328125,0.7395833333333334,0.1671875,0.225
BloodImage_00299.jpg,265.jpg,RBC,204,82,311,190,1,107,108,257,136,0.4015625,0.2833333333333333,0.1671875,0.225
BloodImage_00299.jpg,265.jpg,RBC,33,79,140,187,1,107,108,86,133,0.134375,0.27708333333333335,0.1671875,0.225
BloodImage_00299.jpg,265.jpg,RBC,102,9,233,140,1,131,131,167,74,0.2609375,0.15416666666666667,0.2046875,0.27291666666666664
BloodImage_00299.jpg,265.jpg,RBC,402,212,514,308,1,112,96,458,260,0.715625,0.5416666666666666,0.175,0.2
BloodImage_00299.jpg,265.jpg,RBC,9,359,115,449,1,106,90,62,404,0.096875,0.8416666666666667,0.165625,0.1875
BloodImage_00299.jpg,265.jpg,RBC,1,299,102,410,1,101,111,51,354,0.0796875,0.7375,0.1578125,0.23125
BloodImage_00299.jpg,265.jpg,RBC,424,35,526,122,1,102,87,475,78,0.7421875,0.1625,0.159375,0.18125
BloodImage_00299.jpg,265.jpg,WBC,176,260,408,479,2,232,219,292,369,0.45625,0.76875,0.3625,0.45625
BloodImage_00300.jpg,266.jpg,RBC,379,136,486,246,1,107,110,432,191,0.675,0.39791666666666664,0.1671875,0.22916666666666666
BloodImage_00300.jpg,266.jpg,RBC,474,168,581,278,1,107,110,527,223,0.8234375,0.46458333333333335,0.1671875,0.22916666666666666
BloodImage_00300.jpg,266.jpg,RBC,388,300,495,410,1,107,110,441,355,0.6890625,0.7395833333333334,0.1671875,0.22916666666666666
BloodImage_00300.jpg,266.jpg,RBC,266,331,373,441,1,107,110,319,386,0.4984375,0.8041666666666667,0.1671875,0.22916666666666666
BloodImage_00300.jpg,266.jpg,RBC,201,361,308,471,1,107,110,254,416,0.396875,0.8666666666666667,0.1671875,0.22916666666666666
BloodImage_00300.jpg,266.jpg,RBC,19,297,141,404,1,122,107,80,350,0.125,0.7291666666666666,0.190625,0.22291666666666668
BloodImage_00300.jpg,266.jpg,RBC,359,21,495,124,1,136,103,427,72,0.6671875,0.15,0.2125,0.21458333333333332
BloodImage_00300.jpg,266.jpg,RBC,1,58,92,159,1,91,101,46,108,0.071875,0.225,0.1421875,0.21041666666666667
BloodImage_00300.jpg,266.jpg,RBC,219,33,355,136,1,136,103,287,84,0.4484375,0.175,0.2125,0.21458333333333332
BloodImage_00300.jpg,266.jpg,RBC,133,281,240,391,1,107,110,186,336,0.290625,0.7,0.1671875,0.22916666666666666
BloodImage_00300.jpg,266.jpg,RBC,505,328,612,438,1,107,110,558,383,0.871875,0.7979166666666667,0.1671875,0.22916666666666666
BloodImage_00300.jpg,266.jpg,RBC,487,1,594,105,1,107,104,540,53,0.84375,0.11041666666666666,0.1671875,0.21666666666666667
BloodImage_00300.jpg,266.jpg,RBC,11,406,138,480,1,127,74,74,443,0.115625,0.9229166666666667,0.1984375,0.15416666666666667
BloodImage_00300.jpg,266.jpg,WBC,174,130,357,313,2,183,183,265,221,0.4140625,0.46041666666666664,0.2859375,0.38125
BloodImage_00301.jpg,267.jpg,RBC,278,196,366,291,1,88,95,322,243,0.503125,0.50625,0.1375,0.19791666666666666
BloodImage_00301.jpg,267.jpg,RBC,359,239,447,334,1,88,95,403,286,0.6296875,0.5958333333333333,0.1375,0.19791666666666666
BloodImage_00301.jpg,267.jpg,RBC,523,110,611,205,1,88,95,567,157,0.8859375,0.32708333333333334,0.1375,0.19791666666666666
BloodImage_00301.jpg,267.jpg,RBC,447,198,568,309,1,121,111,507,253,0.7921875,0.5270833333333333,0.1890625,0.23125
BloodImage_00301.jpg,267.jpg,RBC,183,95,304,206,1,121,111,243,150,0.3796875,0.3125,0.1890625,0.23125
BloodImage_00301.jpg,267.jpg,RBC,164,201,268,307,1,104,106,216,254,0.3375,0.5291666666666667,0.1625,0.22083333333333333
BloodImage_00301.jpg,267.jpg,RBC,191,1,295,105,1,104,104,243,53,0.3796875,0.11041666666666666,0.1625,0.21666666666666667
BloodImage_00301.jpg,267.jpg,RBC,90,171,194,277,1,104,106,142,224,0.221875,0.4666666666666667,0.1625,0.22083333333333333
BloodImage_00301.jpg,267.jpg,RBC,496,304,600,410,1,104,106,548,357,0.85625,0.74375,0.1625,0.22083333333333333
BloodImage_00301.jpg,267.jpg,RBC,271,338,375,444,1,104,106,323,391,0.5046875,0.8145833333333333,0.1625,0.22083333333333333
BloodImage_00301.jpg,267.jpg,RBC,157,370,261,476,1,104,106,209,423,0.3265625,0.88125,0.1625,0.22083333333333333
BloodImage_00301.jpg,267.jpg,RBC,1,311,104,417,1,103,106,52,364,0.08125,0.7583333333333333,0.1609375,0.22083333333333333
BloodImage_00301.jpg,267.jpg,RBC,104,285,208,391,1,104,106,156,338,0.24375,0.7041666666666667,0.1625,0.22083333333333333
BloodImage_00301.jpg,267.jpg,WBC,305,13,521,214,2,216,201,413,113,0.6453125,0.23541666666666666,0.3375,0.41875
BloodImage_00301.jpg,267.jpg,Platelets,592,277,630,314,0,38,37,611,295,0.9546875,0.6145833333333334,0.059375,0.07708333333333334
BloodImage_00302.jpg,268.jpg,RBC,99,391,217,471,1,118,80,158,431,0.246875,0.8979166666666667,0.184375,0.16666666666666666
BloodImage_00302.jpg,268.jpg,RBC,121,275,252,388,1,131,113,186,331,0.290625,0.6895833333333333,0.2046875,0.23541666666666666
BloodImage_00302.jpg,268.jpg,RBC,106,19,236,136,1,130,117,171,77,0.2671875,0.16041666666666668,0.203125,0.24375
BloodImage_00302.jpg,268.jpg,RBC,213,63,336,178,1,123,115,274,120,0.428125,0.25,0.1921875,0.23958333333333334
BloodImage_00302.jpg,268.jpg,RBC,511,294,623,410,1,112,116,567,352,0.8859375,0.7333333333333333,0.175,0.24166666666666667
BloodImage_00302.jpg,268.jpg,RBC,461,320,567,413,1,106,93,514,366,0.803125,0.7625,0.165625,0.19375
BloodImage_00302.jpg,268.jpg,RBC,400,339,491,433,1,91,94,445,386,0.6953125,0.8041666666666667,0.1421875,0.19583333333333333
BloodImage_00302.jpg,268.jpg,RBC,343,341,419,433,1,76,92,381,387,0.5953125,0.80625,0.11875,0.19166666666666668
BloodImage_00302.jpg,268.jpg,RBC,295,344,375,443,1,80,99,335,393,0.5234375,0.81875,0.125,0.20625
BloodImage_00302.jpg,268.jpg,RBC,290,241,404,335,1,114,94,347,288,0.5421875,0.6,0.178125,0.19583333333333333
BloodImage_00302.jpg,268.jpg,RBC,429,187,543,281,1,114,94,486,234,0.759375,0.4875,0.178125,0.19583333333333333
BloodImage_00302.jpg,268.jpg,RBC,120,143,248,270,1,128,127,184,206,0.2875,0.42916666666666664,0.2,0.26458333333333334
BloodImage_00302.jpg,268.jpg,WBC,1,291,81,450,2,80,159,41,370,0.0640625,0.7708333333333334,0.125,0.33125
BloodImage_00303.jpg,269.jpg,WBC,46,58,279,264,2,233,206,162,161,0.253125,0.33541666666666664,0.3640625,0.42916666666666664
BloodImage_00304.jpg,270.jpg,RBC,73,30,181,134,1,108,104,127,82,0.1984375,0.17083333333333334,0.16875,0.21666666666666667
BloodImage_00304.jpg,270.jpg,RBC,41,133,147,254,1,106,121,94,193,0.146875,0.40208333333333335,0.165625,0.2520833333333333
BloodImage_00304.jpg,270.jpg,RBC,260,321,366,442,1,106,121,313,381,0.4890625,0.79375,0.165625,0.2520833333333333
BloodImage_00304.jpg,270.jpg,RBC,107,360,209,449,1,102,89,158,404,0.246875,0.8416666666666667,0.159375,0.18541666666666667
BloodImage_00304.jpg,270.jpg,RBC,146,372,248,461,1,102,89,197,416,0.3078125,0.8666666666666667,0.159375,0.18541666666666667
BloodImage_00304.jpg,270.jpg,RBC,1,267,79,371,1,78,104,40,319,0.0625,0.6645833333333333,0.121875,0.21666666666666667
BloodImage_00304.jpg,270.jpg,RBC,366,254,458,350,1,92,96,412,302,0.64375,0.6291666666666667,0.14375,0.2
BloodImage_00304.jpg,270.jpg,RBC,406,139,513,235,1,107,96,459,187,0.7171875,0.38958333333333334,0.1671875,0.2
BloodImage_00304.jpg,270.jpg,RBC,431,1,538,96,1,107,95,484,48,0.75625,0.1,0.1671875,0.19791666666666666
BloodImage_00304.jpg,270.jpg,RBC,279,26,386,122,1,107,96,332,74,0.51875,0.15416666666666667,0.1671875,0.2
BloodImage_00304.jpg,270.jpg,RBC,488,53,600,162,1,112,109,544,107,0.85,0.22291666666666668,0.175,0.22708333333333333
BloodImage_00304.jpg,270.jpg,WBC,170,122,393,327,2,223,205,281,224,0.4390625,0.4666666666666667,0.3484375,0.4270833333333333
BloodImage_00305.jpg,271.jpg,RBC,314,316,424,422,1,110,106,369,369,0.5765625,0.76875,0.171875,0.22083333333333333
BloodImage_00305.jpg,271.jpg,RBC,425,292,552,403,1,127,111,488,347,0.7625,0.7229166666666667,0.1984375,0.23125
BloodImage_00305.jpg,271.jpg,RBC,407,400,539,480,1,132,80,473,440,0.7390625,0.9166666666666666,0.20625,0.16666666666666666
BloodImage_00305.jpg,271.jpg,RBC,289,174,418,283,1,129,109,353,228,0.5515625,0.475,0.2015625,0.22708333333333333
BloodImage_00305.jpg,271.jpg,RBC,139,60,268,169,1,129,109,203,114,0.3171875,0.2375,0.2015625,0.22708333333333333
BloodImage_00305.jpg,271.jpg,RBC,265,49,363,149,1,98,100,314,99,0.490625,0.20625,0.153125,0.20833333333333334
BloodImage_00305.jpg,271.jpg,RBC,341,88,442,180,1,101,92,391,134,0.6109375,0.2791666666666667,0.1578125,0.19166666666666668
BloodImage_00305.jpg,271.jpg,RBC,543,1,640,104,1,97,103,591,52,0.9234375,0.10833333333333334,0.1515625,0.21458333333333332
BloodImage_00305.jpg,271.jpg,RBC,543,118,640,222,1,97,104,591,170,0.9234375,0.3541666666666667,0.1515625,0.21666666666666667
BloodImage_00305.jpg,271.jpg,RBC,453,179,564,297,1,111,118,508,238,0.79375,0.49583333333333335,0.1734375,0.24583333333333332
BloodImage_00305.jpg,271.jpg,RBC,167,386,278,480,1,111,94,222,433,0.346875,0.9020833333333333,0.1734375,0.19583333333333333
BloodImage_00305.jpg,271.jpg,RBC,92,309,204,420,1,112,111,148,364,0.23125,0.7583333333333333,0.175,0.23125
BloodImage_00305.jpg,271.jpg,RBC,86,202,198,313,1,112,111,142,257,0.221875,0.5354166666666667,0.175,0.23125
BloodImage_00305.jpg,271.jpg,WBC,190,244,309,370,2,119,126,249,307,0.3890625,0.6395833333333333,0.1859375,0.2625
BloodImage_00305.jpg,271.jpg,Platelets,1,28,26,70,0,25,42,13,49,0.0203125,0.10208333333333333,0.0390625,0.0875
BloodImage_00307.jpg,272.jpg,RBC,81,18,194,115,1,113,97,137,66,0.2140625,0.1375,0.1765625,0.20208333333333334
BloodImage_00307.jpg,272.jpg,RBC,43,259,144,351,1,101,92,93,305,0.1453125,0.6354166666666666,0.1578125,0.19166666666666668
BloodImage_00307.jpg,272.jpg,RBC,347,355,448,447,1,101,92,397,401,0.6203125,0.8354166666666667,0.1578125,0.19166666666666668
BloodImage_00307.jpg,272.jpg,RBC,97,362,198,454,1,101,92,147,408,0.2296875,0.85,0.1578125,0.19166666666666668
BloodImage_00307.jpg,272.jpg,RBC,195,167,297,277,1,102,110,246,222,0.384375,0.4625,0.159375,0.22916666666666666
BloodImage_00307.jpg,272.jpg,RBC,399,232,501,342,1,102,110,450,287,0.703125,0.5979166666666667,0.159375,0.22916666666666666
BloodImage_00307.jpg,272.jpg,RBC,536,274,638,384,1,102,110,587,329,0.9171875,0.6854166666666667,0.159375,0.22916666666666666
BloodImage_00307.jpg,272.jpg,RBC,559,136,640,245,1,81,109,599,190,0.9359375,0.3958333333333333,0.1265625,0.22708333333333333
BloodImage_00307.jpg,272.jpg,RBC,66,136,153,241,1,87,105,109,188,0.1703125,0.39166666666666666,0.1359375,0.21875
BloodImage_00307.jpg,272.jpg,RBC,266,181,368,291,1,102,110,317,236,0.4953125,0.49166666666666664,0.159375,0.22916666666666666
BloodImage_00307.jpg,272.jpg,RBC,254,268,356,378,1,102,110,305,323,0.4765625,0.6729166666666667,0.159375,0.22916666666666666
BloodImage_00307.jpg,272.jpg,RBC,225,358,328,457,1,103,99,276,407,0.43125,0.8479166666666667,0.1609375,0.20625
BloodImage_00307.jpg,272.jpg,WBC,285,30,509,238,2,224,208,397,134,0.6203125,0.2791666666666667,0.35,0.43333333333333335
BloodImage_00307.jpg,272.jpg,Platelets,477,411,523,440,0,46,29,500,425,0.78125,0.8854166666666666,0.071875,0.06041666666666667
BloodImage_00308.jpg,273.jpg,RBC,184,105,287,227,1,103,122,235,166,0.3671875,0.3458333333333333,0.1609375,0.25416666666666665
BloodImage_00308.jpg,273.jpg,RBC,75,85,186,204,1,111,119,130,144,0.203125,0.3,0.1734375,0.24791666666666667
BloodImage_00308.jpg,273.jpg,RBC,291,195,407,333,1,116,138,349,264,0.5453125,0.55,0.18125,0.2875
BloodImage_00308.jpg,273.jpg,RBC,500,313,609,417,1,109,104,554,365,0.865625,0.7604166666666666,0.1703125,0.21666666666666667
BloodImage_00308.jpg,273.jpg,RBC,269,54,366,155,1,97,101,317,104,0.4953125,0.21666666666666667,0.1515625,0.21041666666666667
BloodImage_00308.jpg,273.jpg,RBC,128,1,222,72,1,94,71,175,36,0.2734375,0.075,0.146875,0.14791666666666667
BloodImage_00308.jpg,273.jpg,RBC,479,172,576,273,1,97,101,527,222,0.8234375,0.4625,0.1515625,0.21041666666666667
BloodImage_00308.jpg,273.jpg,RBC,508,28,626,143,1,118,115,567,85,0.8859375,0.17708333333333334,0.184375,0.23958333333333334
BloodImage_00308.jpg,273.jpg,RBC,1,170,90,279,1,89,109,45,224,0.0703125,0.4666666666666667,0.1390625,0.22708333333333333
BloodImage_00308.jpg,273.jpg,RBC,415,322,501,417,1,86,95,458,369,0.715625,0.76875,0.134375,0.19791666666666666
BloodImage_00308.jpg,273.jpg,RBC,387,96,484,197,1,97,101,435,146,0.6796875,0.30416666666666664,0.1515625,0.21041666666666667
BloodImage_00308.jpg,273.jpg,WBC,143,313,340,480,2,197,167,241,396,0.3765625,0.825,0.3078125,0.34791666666666665
BloodImage_00309.jpg,274.jpg,RBC,216,279,330,379,1,114,100,273,329,0.4265625,0.6854166666666667,0.178125,0.20833333333333334
BloodImage_00309.jpg,274.jpg,RBC,117,345,230,475,1,113,130,173,410,0.2703125,0.8541666666666666,0.1765625,0.2708333333333333
BloodImage_00309.jpg,274.jpg,RBC,452,314,566,414,1,114,100,509,364,0.7953125,0.7583333333333333,0.178125,0.20833333333333334
BloodImage_00309.jpg,274.jpg,RBC,385,317,499,417,1,114,100,442,367,0.690625,0.7645833333333333,0.178125,0.20833333333333334
BloodImage_00309.jpg,274.jpg,RBC,505,222,608,325,1,103,103,556,273,0.86875,0.56875,0.1609375,0.21458333333333332
BloodImage_00309.jpg,274.jpg,RBC,488,179,588,271,1,100,92,538,225,0.840625,0.46875,0.15625,0.19166666666666668
BloodImage_00309.jpg,274.jpg,RBC,477,57,577,149,1,100,92,527,103,0.8234375,0.21458333333333332,0.15625,0.19166666666666668
BloodImage_00309.jpg,274.jpg,RBC,426,70,526,162,1,100,92,476,116,0.74375,0.24166666666666667,0.15625,0.19166666666666668
BloodImage_00309.jpg,274.jpg,RBC,376,169,482,272,1,106,103,429,220,0.6703125,0.4583333333333333,0.165625,0.21458333333333332
BloodImage_00309.jpg,274.jpg,RBC,1,179,96,278,1,95,99,48,228,0.075,0.475,0.1484375,0.20625
BloodImage_00309.jpg,274.jpg,RBC,1,1,96,98,1,95,97,48,49,0.075,0.10208333333333333,0.1484375,0.20208333333333334
BloodImage_00309.jpg,274.jpg,RBC,286,197,382,296,1,96,99,334,246,0.521875,0.5125,0.15,0.20625
BloodImage_00309.jpg,274.jpg,WBC,123,1,361,196,2,238,195,242,98,0.378125,0.20416666666666666,0.371875,0.40625
BloodImage_00310.jpg,275.jpg,RBC,20,314,137,432,1,117,118,78,373,0.121875,0.7770833333333333,0.1828125,0.24583333333333332
BloodImage_00310.jpg,275.jpg,RBC,294,70,389,173,1,95,103,341,121,0.5328125,0.2520833333333333,0.1484375,0.21458333333333332
BloodImage_00310.jpg,275.jpg,RBC,168,18,291,112,1,123,94,229,65,0.3578125,0.13541666666666666,0.1921875,0.19583333333333333
BloodImage_00310.jpg,275.jpg,RBC,378,53,485,149,1,107,96,431,101,0.6734375,0.21041666666666667,0.1671875,0.2
BloodImage_00310.jpg,275.jpg,RBC,357,383,464,479,1,107,96,410,431,0.640625,0.8979166666666667,0.1671875,0.2
BloodImage_00310.jpg,275.jpg,RBC,388,214,495,310,1,107,96,441,262,0.6890625,0.5458333333333333,0.1671875,0.2
BloodImage_00310.jpg,275.jpg,RBC,383,166,490,262,1,107,96,436,214,0.68125,0.44583333333333336,0.1671875,0.2
BloodImage_00310.jpg,275.jpg,RBC,504,66,613,195,1,109,129,558,130,0.871875,0.2708333333333333,0.1703125,0.26875
BloodImage_00310.jpg,275.jpg,RBC,108,28,202,134,1,94,106,155,81,0.2421875,0.16875,0.146875,0.22083333333333333
BloodImage_00310.jpg,275.jpg,RBC,181,343,275,449,1,94,106,228,396,0.35625,0.825,0.146875,0.22083333333333333
BloodImage_00310.jpg,275.jpg,RBC,435,310,550,414,1,115,104,492,362,0.76875,0.7541666666666667,0.1796875,0.21666666666666667
BloodImage_00310.jpg,275.jpg,Platelets,346,313,383,344,0,37,31,364,328,0.56875,0.6833333333333333,0.0578125,0.06458333333333334
BloodImage_00310.jpg,275.jpg,Platelets,304,368,340,406,0,36,38,322,387,0.503125,0.80625,0.05625,0.07916666666666666
BloodImage_00310.jpg,275.jpg,Platelets,70,91,112,132,0,42,41,91,111,0.1421875,0.23125,0.065625,0.08541666666666667
BloodImage_00310.jpg,275.jpg,WBC,59,127,287,359,2,228,232,173,243,0.2703125,0.50625,0.35625,0.48333333333333334
BloodImage_00311.jpg,276.jpg,RBC,427,87,533,181,1,106,94,480,134,0.75,0.2791666666666667,0.165625,0.19583333333333333
BloodImage_00311.jpg,276.jpg,RBC,399,169,506,270,1,107,101,452,219,0.70625,0.45625,0.1671875,0.21041666666666667
BloodImage_00311.jpg,276.jpg,RBC,429,1,538,78,1,109,77,483,39,0.7546875,0.08125,0.1703125,0.16041666666666668
BloodImage_00311.jpg,276.jpg,RBC,39,95,144,201,1,105,106,91,148,0.1421875,0.30833333333333335,0.1640625,0.22083333333333333
BloodImage_00311.jpg,276.jpg,RBC,283,328,401,435,1,118,107,342,381,0.534375,0.79375,0.184375,0.22291666666666668
BloodImage_00311.jpg,276.jpg,RBC,418,260,536,367,1,118,107,477,313,0.7453125,0.6520833333333333,0.184375,0.22291666666666668
BloodImage_00311.jpg,276.jpg,RBC,1,168,72,254,1,71,86,36,211,0.05625,0.4395833333333333,0.1109375,0.17916666666666667
BloodImage_00311.jpg,276.jpg,RBC,22,283,146,377,1,124,94,84,330,0.13125,0.6875,0.19375,0.19583333333333333
BloodImage_00311.jpg,276.jpg,WBC,194,150,385,349,2,191,199,289,249,0.4515625,0.51875,0.2984375,0.41458333333333336
BloodImage_00311.jpg,276.jpg,Platelets,500,189,556,234,0,56,45,528,211,0.825,0.4395833333333333,0.0875,0.09375
BloodImage_00312.jpg,277.jpg,RBC,98,203,197,294,1,99,91,147,248,0.2296875,0.5166666666666667,0.1546875,0.18958333333333333
BloodImage_00312.jpg,277.jpg,RBC,172,184,271,275,1,99,91,221,229,0.3453125,0.47708333333333336,0.1546875,0.18958333333333333
BloodImage_00312.jpg,277.jpg,RBC,485,296,584,395,1,99,99,534,345,0.834375,0.71875,0.1546875,0.20625
BloodImage_00312.jpg,277.jpg,RBC,534,138,633,237,1,99,99,583,187,0.9109375,0.38958333333333334,0.1546875,0.20625
BloodImage_00312.jpg,277.jpg,RBC,447,381,563,478,1,116,97,505,429,0.7890625,0.89375,0.18125,0.20208333333333334
BloodImage_00312.jpg,277.jpg,RBC,316,98,432,195,1,116,97,374,146,0.584375,0.30416666666666664,0.18125,0.20208333333333334
BloodImage_00312.jpg,277.jpg,RBC,567,337,640,463,1,73,126,603,400,0.9421875,0.8333333333333334,0.1140625,0.2625
BloodImage_00312.jpg,277.jpg,WBC,78,275,323,480,2,245,205,200,377,0.3125,0.7854166666666667,0.3828125,0.4270833333333333
BloodImage_00312.jpg,277.jpg,Platelets,326,186,367,217,0,41,31,346,201,0.540625,0.41875,0.0640625,0.06458333333333334
BloodImage_00312.jpg,277.jpg,Platelets,339,213,374,253,0,35,40,356,233,0.55625,0.48541666666666666,0.0546875,0.08333333333333333
BloodImage_00312.jpg,277.jpg,Platelets,370,212,406,247,0,36,35,388,229,0.60625,0.47708333333333336,0.05625,0.07291666666666667
BloodImage_00312.jpg,277.jpg,Platelets,269,294,309,328,0,40,34,289,311,0.4515625,0.6479166666666667,0.0625,0.07083333333333333
BloodImage_00313.jpg,278.jpg,RBC,24,94,131,202,1,107,108,77,148,0.1203125,0.30833333333333335,0.1671875,0.225
BloodImage_00313.jpg,278.jpg,RBC,402,251,525,358,1,123,107,463,304,0.7234375,0.6333333333333333,0.1921875,0.22291666666666668
BloodImage_00313.jpg,278.jpg,RBC,411,373,534,480,1,123,107,472,426,0.7375,0.8875,0.1921875,0.22291666666666668
BloodImage_00313.jpg,278.jpg,RBC,538,1,637,106,1,99,105,587,53,0.9171875,0.11041666666666666,0.1546875,0.21875
BloodImage_00313.jpg,278.jpg,RBC,342,154,434,249,1,92,95,388,201,0.60625,0.41875,0.14375,0.19791666666666666
BloodImage_00313.jpg,278.jpg,RBC,452,73,559,172,1,107,99,505,122,0.7890625,0.25416666666666665,0.1671875,0.20625
BloodImage_00313.jpg,278.jpg,RBC,99,228,206,327,1,107,99,152,277,0.2375,0.5770833333333333,0.1671875,0.20625
BloodImage_00313.jpg,278.jpg,RBC,36,239,156,344,1,120,105,96,291,0.15,0.60625,0.1875,0.21875
BloodImage_00313.jpg,278.jpg,RBC,156,63,260,168,1,104,105,208,115,0.325,0.23958333333333334,0.1625,0.21875
BloodImage_00313.jpg,278.jpg,RBC,388,165,476,250,1,88,85,432,207,0.675,0.43125,0.1375,0.17708333333333334
BloodImage_00313.jpg,278.jpg,WBC,101,373,269,480,2,168,107,185,426,0.2890625,0.8875,0.2625,0.22291666666666668
BloodImage_00313.jpg,278.jpg,WBC,180,215,404,457,2,224,242,292,336,0.45625,0.7,0.35,0.5041666666666667
BloodImage_00314.jpg,279.jpg,RBC,445,41,545,138,1,100,97,495,89,0.7734375,0.18541666666666667,0.15625,0.20208333333333334
BloodImage_00314.jpg,279.jpg,RBC,471,210,571,307,1,100,97,521,258,0.8140625,0.5375,0.15625,0.20208333333333334
BloodImage_00314.jpg,279.jpg,RBC,1,1,100,97,1,99,96,50,49,0.078125,0.10208333333333333,0.1546875,0.2
BloodImage_00314.jpg,279.jpg,RBC,3,130,103,227,1,100,97,53,178,0.0828125,0.37083333333333335,0.15625,0.20208333333333334
BloodImage_00314.jpg,279.jpg,RBC,63,267,163,364,1,100,97,113,315,0.1765625,0.65625,0.15625,0.20208333333333334
BloodImage_00314.jpg,279.jpg,RBC,340,324,454,423,1,114,99,397,373,0.6203125,0.7770833333333333,0.178125,0.20625
BloodImage_00314.jpg,279.jpg,RBC,526,212,637,340,1,111,128,581,276,0.9078125,0.575,0.1734375,0.26666666666666666
BloodImage_00314.jpg,279.jpg,RBC,256,257,360,341,1,104,84,308,299,0.48125,0.6229166666666667,0.1625,0.175
BloodImage_00314.jpg,279.jpg,RBC,336,127,437,217,1,101,90,386,172,0.603125,0.35833333333333334,0.1578125,0.1875
BloodImage_00314.jpg,279.jpg,RBC,353,389,454,480,1,101,91,403,434,0.6296875,0.9041666666666667,0.1578125,0.18958333333333333
BloodImage_00314.jpg,279.jpg,Platelets,187,427,231,470,0,44,43,209,448,0.3265625,0.9333333333333333,0.06875,0.08958333333333333
BloodImage_00314.jpg,279.jpg,Platelets,547,386,582,417,0,35,31,564,401,0.88125,0.8354166666666667,0.0546875,0.06458333333333334
BloodImage_00314.jpg,279.jpg,Platelets,77,230,116,268,0,39,38,96,249,0.15,0.51875,0.0609375,0.07916666666666666
BloodImage_00314.jpg,279.jpg,Platelets,98,49,143,85,0,45,36,120,67,0.1875,0.13958333333333334,0.0703125,0.075
BloodImage_00314.jpg,279.jpg,Platelets,259,1,297,26,0,38,25,278,13,0.434375,0.027083333333333334,0.059375,0.052083333333333336
BloodImage_00314.jpg,279.jpg,WBC,92,45,329,266,2,237,221,210,155,0.328125,0.3229166666666667,0.3703125,0.46041666666666664
BloodImage_00315.jpg,280.jpg,RBC,164,261,297,364,1,133,103,230,312,0.359375,0.65,0.2078125,0.21458333333333332
BloodImage_00315.jpg,280.jpg,RBC,15,66,148,169,1,133,103,81,117,0.1265625,0.24375,0.2078125,0.21458333333333332
BloodImage_00315.jpg,280.jpg,RBC,13,234,132,333,1,119,99,72,283,0.1125,0.5895833333333333,0.1859375,0.20625
BloodImage_00315.jpg,280.jpg,RBC,239,3,354,107,1,115,104,296,55,0.4625,0.11458333333333333,0.1796875,0.21666666666666667
BloodImage_00315.jpg,280.jpg,RBC,542,109,640,214,1,98,105,591,161,0.9234375,0.33541666666666664,0.153125,0.21875
BloodImage_00315.jpg,280.jpg,RBC,441,293,539,398,1,98,105,490,345,0.765625,0.71875,0.153125,0.21875
BloodImage_00315.jpg,280.jpg,RBC,273,198,383,309,1,110,111,328,253,0.5125,0.5270833333333333,0.171875,0.23125
BloodImage_00315.jpg,280.jpg,RBC,148,129,277,251,1,129,122,212,190,0.33125,0.3958333333333333,0.2015625,0.25416666666666665
BloodImage_00315.jpg,280.jpg,RBC,363,69,466,160,1,103,91,414,114,0.646875,0.2375,0.1609375,0.18958333333333333
BloodImage_00315.jpg,280.jpg,RBC,382,190,469,296,1,87,106,425,243,0.6640625,0.50625,0.1359375,0.22083333333333333
BloodImage_00315.jpg,280.jpg,WBC,250,343,487,480,2,237,137,368,411,0.575,0.85625,0.3703125,0.28541666666666665
BloodImage_00315.jpg,280.jpg,Platelets,567,234,619,277,0,52,43,593,255,0.9265625,0.53125,0.08125,0.08958333333333333
BloodImage_00317.jpg,281.jpg,RBC,525,356,634,462,1,109,106,579,409,0.9046875,0.8520833333333333,0.1703125,0.22083333333333333
BloodImage_00317.jpg,281.jpg,RBC,432,339,541,445,1,109,106,486,392,0.759375,0.8166666666666667,0.1703125,0.22083333333333333
BloodImage_00317.jpg,281.jpg,RBC,131,361,224,465,1,93,104,177,413,0.2765625,0.8604166666666667,0.1453125,0.21666666666666667
BloodImage_00317.jpg,281.jpg,RBC,309,280,428,401,1,119,121,368,340,0.575,0.7083333333333334,0.1859375,0.2520833333333333
BloodImage_00317.jpg,281.jpg,RBC,359,196,478,317,1,119,121,418,256,0.653125,0.5333333333333333,0.1859375,0.2520833333333333
BloodImage_00317.jpg,281.jpg,RBC,390,1,501,113,1,111,112,445,57,0.6953125,0.11875,0.1734375,0.23333333333333334
BloodImage_00317.jpg,281.jpg,RBC,473,200,572,297,1,99,97,522,248,0.815625,0.5166666666666667,0.1546875,0.20208333333333334
BloodImage_00317.jpg,281.jpg,RBC,47,93,154,204,1,107,111,100,148,0.15625,0.30833333333333335,0.1671875,0.23125
BloodImage_00317.jpg,281.jpg,RBC,57,290,179,390,1,122,100,118,340,0.184375,0.7083333333333334,0.190625,0.20833333333333334
BloodImage_00317.jpg,281.jpg,RBC,206,279,311,374,1,105,95,258,326,0.403125,0.6791666666666667,0.1640625,0.19791666666666666
BloodImage_00317.jpg,281.jpg,RBC,216,385,321,480,1,105,95,268,432,0.41875,0.9,0.1640625,0.19791666666666666
BloodImage_00317.jpg,281.jpg,RBC,114,26,219,137,1,105,111,166,81,0.259375,0.16875,0.1640625,0.23125
BloodImage_00317.jpg,281.jpg,RBC,192,1,291,92,1,99,91,241,46,0.3765625,0.09583333333333334,0.1546875,0.18958333333333333
BloodImage_00317.jpg,281.jpg,Platelets,518,147,551,192,0,33,45,534,169,0.834375,0.35208333333333336,0.0515625,0.09375
BloodImage_00317.jpg,281.jpg,Platelets,427,140,482,192,0,55,52,454,166,0.709375,0.3458333333333333,0.0859375,0.10833333333333334
BloodImage_00317.jpg,281.jpg,Platelets,112,207,153,252,0,41,45,132,229,0.20625,0.47708333333333336,0.0640625,0.09375
BloodImage_00317.jpg,281.jpg,Platelets,114,174,152,209,0,38,35,133,191,0.2078125,0.39791666666666664,0.059375,0.07291666666666667
BloodImage_00317.jpg,281.jpg,WBC,184,65,396,260,2,212,195,290,162,0.453125,0.3375,0.33125,0.40625
BloodImage_00318.jpg,282.jpg,RBC,94,247,201,335,1,107,88,147,291,0.2296875,0.60625,0.1671875,0.18333333333333332
BloodImage_00318.jpg,282.jpg,RBC,35,392,142,480,1,107,88,88,436,0.1375,0.9083333333333333,0.1671875,0.18333333333333332
BloodImage_00318.jpg,282.jpg,RBC,252,25,359,114,1,107,89,305,69,0.4765625,0.14375,0.1671875,0.18541666666666667
BloodImage_00318.jpg,282.jpg,RBC,466,325,577,446,1,111,121,521,385,0.8140625,0.8020833333333334,0.1734375,0.2520833333333333
BloodImage_00318.jpg,282.jpg,RBC,377,60,488,182,1,111,122,432,121,0.675,0.2520833333333333,0.1734375,0.25416666666666665
BloodImage_00318.jpg,282.jpg,RBC,397,400,504,480,1,107,80,450,440,0.703125,0.9166666666666666,0.1671875,0.16666666666666666
BloodImage_00318.jpg,282.jpg,RBC,66,139,162,216,1,96,77,114,177,0.178125,0.36875,0.15,0.16041666666666668
BloodImage_00318.jpg,282.jpg,RBC,96,23,209,136,1,113,113,152,79,0.2375,0.16458333333333333,0.1765625,0.23541666666666666
BloodImage_00318.jpg,282.jpg,RBC,470,95,560,212,1,90,117,515,153,0.8046875,0.31875,0.140625,0.24375
BloodImage_00318.jpg,282.jpg,RBC,125,133,219,217,1,94,84,172,175,0.26875,0.3645833333333333,0.146875,0.175
BloodImage_00318.jpg,282.jpg,RBC,1,268,82,392,1,81,124,41,330,0.0640625,0.6875,0.1265625,0.25833333333333336
BloodImage_00318.jpg,282.jpg,WBC,160,225,397,447,2,237,222,278,336,0.434375,0.7,0.3703125,0.4625
BloodImage_00319.jpg,283.jpg,RBC,416,371,512,478,1,96,107,464,424,0.725,0.8833333333333333,0.15,0.22291666666666668
BloodImage_00319.jpg,283.jpg,RBC,460,90,566,195,1,106,105,513,142,0.8015625,0.29583333333333334,0.165625,0.21875
BloodImage_00319.jpg,283.jpg,RBC,414,245,532,340,1,118,95,473,292,0.7390625,0.6083333333333333,0.184375,0.19791666666666666
BloodImage_00319.jpg,283.jpg,RBC,188,274,278,374,1,90,100,233,324,0.3640625,0.675,0.140625,0.20833333333333334
BloodImage_00319.jpg,283.jpg,RBC,117,344,216,440,1,99,96,166,392,0.259375,0.8166666666666667,0.1546875,0.2
BloodImage_00319.jpg,283.jpg,RBC,148,392,250,470,1,102,78,199,431,0.3109375,0.8979166666666667,0.159375,0.1625
BloodImage_00319.jpg,283.jpg,RBC,309,65,418,168,1,109,103,363,116,0.5671875,0.24166666666666667,0.1703125,0.21458333333333332
BloodImage_00319.jpg,283.jpg,RBC,403,265,493,359,1,90,94,448,312,0.7,0.65,0.140625,0.19583333333333333
BloodImage_00319.jpg,283.jpg,RBC,565,117,638,224,1,73,107,601,170,0.9390625,0.3541666666666667,0.1140625,0.22291666666666668
BloodImage_00319.jpg,283.jpg,RBC,555,39,640,132,1,85,93,597,85,0.9328125,0.17708333333333334,0.1328125,0.19375
BloodImage_00319.jpg,283.jpg,WBC,72,1,327,209,2,255,208,199,105,0.3109375,0.21875,0.3984375,0.43333333333333335
BloodImage_00319.jpg,283.jpg,Platelets,591,391,632,429,0,41,38,611,410,0.9546875,0.8541666666666666,0.0640625,0.07916666666666666
BloodImage_00319.jpg,283.jpg,Platelets,36,233,74,262,0,38,29,55,247,0.0859375,0.5145833333333333,0.059375,0.06041666666666667
BloodImage_00320.jpg,284.jpg,RBC,349,249,476,362,1,127,113,412,305,0.64375,0.6354166666666666,0.1984375,0.23541666666666666
BloodImage_00320.jpg,284.jpg,RBC,255,277,363,402,1,108,125,309,339,0.4828125,0.70625,0.16875,0.2604166666666667
BloodImage_00320.jpg,284.jpg,RBC,163,317,264,399,1,101,82,213,358,0.3328125,0.7458333333333333,0.1578125,0.17083333333333334
BloodImage_00320.jpg,284.jpg,RBC,132,349,242,434,1,110,85,187,391,0.2921875,0.8145833333333333,0.171875,0.17708333333333334
BloodImage_00320.jpg,284.jpg,RBC,1,376,96,476,1,95,100,48,426,0.075,0.8875,0.1484375,0.20833333333333334
BloodImage_00320.jpg,284.jpg,RBC,85,90,165,186,1,80,96,125,138,0.1953125,0.2875,0.125,0.2
BloodImage_00320.jpg,284.jpg,RBC,532,147,629,253,1,97,106,580,200,0.90625,0.4166666666666667,0.1515625,0.22083333333333333
BloodImage_00320.jpg,284.jpg,RBC,445,364,550,463,1,105,99,497,413,0.7765625,0.8604166666666667,0.1640625,0.20625
BloodImage_00320.jpg,284.jpg,RBC,437,54,548,159,1,111,105,492,106,0.76875,0.22083333333333333,0.1734375,0.21875
BloodImage_00320.jpg,284.jpg,RBC,303,53,395,141,1,92,88,349,97,0.5453125,0.20208333333333334,0.14375,0.18333333333333332
BloodImage_00320.jpg,284.jpg,RBC,254,28,344,122,1,90,94,299,75,0.4671875,0.15625,0.140625,0.19583333333333333
BloodImage_00320.jpg,284.jpg,WBC,131,115,334,338,2,203,223,232,226,0.3625,0.4708333333333333,0.3171875,0.46458333333333335
BloodImage_00322.jpg,285.jpg,Platelets,168,374,198,406,0,30,32,183,390,0.2859375,0.8125,0.046875,0.06666666666666667
BloodImage_00322.jpg,285.jpg,Platelets,527,244,564,282,0,37,38,545,263,0.8515625,0.5479166666666667,0.0578125,0.07916666666666666
BloodImage_00322.jpg,285.jpg,Platelets,565,383,602,421,0,37,38,583,402,0.9109375,0.8375,0.0578125,0.07916666666666666
BloodImage_00322.jpg,285.jpg,WBC,307,174,528,387,2,221,213,417,280,0.6515625,0.5833333333333334,0.3453125,0.44375
BloodImage_00323.jpg,286.jpg,WBC,22,120,330,360,2,308,240,176,240,0.275,0.5,0.48125,0.5
BloodImage_00323.jpg,286.jpg,RBC,353,343,445,444,1,92,101,399,393,0.6234375,0.81875,0.14375,0.21041666666666667
BloodImage_00323.jpg,286.jpg,RBC,523,257,640,379,1,117,122,581,318,0.9078125,0.6625,0.1828125,0.25416666666666665
BloodImage_00323.jpg,286.jpg,RBC,539,364,640,457,1,101,93,589,410,0.9203125,0.8541666666666666,0.1578125,0.19375
BloodImage_00323.jpg,286.jpg,RBC,339,170,475,278,1,136,108,407,224,0.6359375,0.4666666666666667,0.2125,0.225
BloodImage_00323.jpg,286.jpg,RBC,66,1,173,111,1,107,110,119,56,0.1859375,0.11666666666666667,0.1671875,0.22916666666666666
BloodImage_00324.jpg,287.jpg,RBC,376,191,476,294,1,100,103,426,242,0.665625,0.5041666666666667,0.15625,0.21458333333333332
BloodImage_00324.jpg,287.jpg,RBC,326,189,429,317,1,103,128,377,253,0.5890625,0.5270833333333333,0.1609375,0.26666666666666666
BloodImage_00324.jpg,287.jpg,RBC,484,213,601,325,1,117,112,542,269,0.846875,0.5604166666666667,0.1828125,0.23333333333333334
BloodImage_00324.jpg,287.jpg,RBC,529,314,631,411,1,102,97,580,362,0.90625,0.7541666666666667,0.159375,0.20208333333333334
BloodImage_00324.jpg,287.jpg,RBC,201,206,310,316,1,109,110,255,261,0.3984375,0.54375,0.1703125,0.22916666666666666
BloodImage_00324.jpg,287.jpg,RBC,22,105,114,201,1,92,96,68,153,0.10625,0.31875,0.14375,0.2
BloodImage_00324.jpg,287.jpg,RBC,11,324,103,422,1,92,98,57,373,0.0890625,0.7770833333333333,0.14375,0.20416666666666666
BloodImage_00324.jpg,287.jpg,RBC,519,22,608,106,1,89,84,563,64,0.8796875,0.13333333333333333,0.1390625,0.175
BloodImage_00324.jpg,287.jpg,RBC,231,117,319,206,1,88,89,275,161,0.4296875,0.33541666666666664,0.1375,0.18541666666666667
BloodImage_00324.jpg,287.jpg,RBC,57,350,177,465,1,120,115,117,407,0.1828125,0.8479166666666667,0.1875,0.23958333333333334
BloodImage_00324.jpg,287.jpg,RBC,244,349,369,449,1,125,100,306,399,0.478125,0.83125,0.1953125,0.20833333333333334
BloodImage_00324.jpg,287.jpg,WBC,277,1,500,169,2,223,168,388,85,0.60625,0.17708333333333334,0.3484375,0.35
BloodImage_00325.jpg,288.jpg,RBC,480,357,601,472,1,121,115,540,414,0.84375,0.8625,0.1890625,0.23958333333333334
BloodImage_00325.jpg,288.jpg,RBC,370,202,491,317,1,121,115,430,259,0.671875,0.5395833333333333,0.1890625,0.23958333333333334
BloodImage_00325.jpg,288.jpg,RBC,376,124,466,206,1,90,82,421,165,0.6578125,0.34375,0.140625,0.17083333333333334
BloodImage_00325.jpg,288.jpg,RBC,75,160,139,274,1,64,114,107,217,0.1671875,0.45208333333333334,0.1,0.2375
BloodImage_00325.jpg,288.jpg,RBC,85,258,182,347,1,97,89,133,302,0.2078125,0.6291666666666667,0.1515625,0.18541666666666667
BloodImage_00325.jpg,288.jpg,RBC,72,1,157,79,1,85,78,114,40,0.178125,0.08333333333333333,0.1328125,0.1625
BloodImage_00325.jpg,288.jpg,RBC,221,19,316,108,1,95,89,268,63,0.41875,0.13125,0.1484375,0.18541666666666667
BloodImage_00325.jpg,288.jpg,RBC,265,51,390,151,1,125,100,327,101,0.5109375,0.21041666666666667,0.1953125,0.20833333333333334
BloodImage_00325.jpg,288.jpg,RBC,459,79,549,161,1,90,82,504,120,0.7875,0.25,0.140625,0.17083333333333334
BloodImage_00325.jpg,288.jpg,RBC,253,321,415,388,1,162,67,334,354,0.521875,0.7375,0.253125,0.13958333333333334
BloodImage_00325.jpg,288.jpg,RBC,240,329,341,422,1,101,93,290,375,0.453125,0.78125,0.1578125,0.19375
BloodImage_00325.jpg,288.jpg,Platelets,16,198,53,236,0,37,38,34,217,0.053125,0.45208333333333334,0.0578125,0.07916666666666666
BloodImage_00325.jpg,288.jpg,Platelets,121,96,166,143,0,45,47,143,119,0.2234375,0.24791666666666667,0.0703125,0.09791666666666667
BloodImage_00325.jpg,288.jpg,Platelets,421,392,482,445,0,61,53,451,418,0.7046875,0.8708333333333333,0.0953125,0.11041666666666666
BloodImage_00325.jpg,288.jpg,WBC,141,97,338,312,2,197,215,239,204,0.3734375,0.425,0.3078125,0.4479166666666667
BloodImage_00326.jpg,289.jpg,RBC,372,64,499,195,1,127,131,435,129,0.6796875,0.26875,0.1984375,0.27291666666666664
BloodImage_00326.jpg,289.jpg,RBC,421,267,545,367,1,124,100,483,317,0.7546875,0.6604166666666667,0.19375,0.20833333333333334
BloodImage_00326.jpg,289.jpg,RBC,95,174,211,270,1,116,96,153,222,0.2390625,0.4625,0.18125,0.2
BloodImage_00326.jpg,289.jpg,RBC,293,194,399,284,1,106,90,346,239,0.540625,0.4979166666666667,0.165625,0.1875
BloodImage_00326.jpg,289.jpg,RBC,328,1,456,71,1,128,70,392,36,0.6125,0.075,0.2,0.14583333333333334
BloodImage_00326.jpg,289.jpg,RBC,88,57,190,158,1,102,101,139,107,0.2171875,0.22291666666666668,0.159375,0.21041666666666667
BloodImage_00326.jpg,289.jpg,RBC,534,22,639,127,1,105,105,586,74,0.915625,0.15416666666666667,0.1640625,0.21875
BloodImage_00326.jpg,289.jpg,RBC,483,100,582,222,1,99,122,532,161,0.83125,0.33541666666666664,0.1546875,0.25416666666666665
BloodImage_00326.jpg,289.jpg,RBC,529,411,621,480,1,92,69,575,445,0.8984375,0.9270833333333334,0.14375,0.14375
BloodImage_00326.jpg,289.jpg,RBC,173,3,262,103,1,89,100,217,53,0.3390625,0.11041666666666666,0.1390625,0.20833333333333334
BloodImage_00326.jpg,289.jpg,Platelets,87,406,137,449,0,50,43,112,427,0.175,0.8895833333333333,0.078125,0.08958333333333333
BloodImage_00326.jpg,289.jpg,WBC,209,267,460,480,2,251,213,334,373,0.521875,0.7770833333333333,0.3921875,0.44375
BloodImage_00327.jpg,290.jpg,Platelets,106,109,146,139,0,40,30,126,124,0.196875,0.25833333333333336,0.0625,0.0625
BloodImage_00327.jpg,290.jpg,Platelets,331,102,379,142,0,48,40,355,122,0.5546875,0.25416666666666665,0.075,0.08333333333333333
BloodImage_00330.jpg,291.jpg,WBC,279,365,499,480,2,220,115,389,422,0.6078125,0.8791666666666667,0.34375,0.23958333333333334
BloodImage_00331.jpg,292.jpg,RBC,124,195,240,294,1,116,99,182,244,0.284375,0.5083333333333333,0.18125,0.20625
BloodImage_00331.jpg,292.jpg,RBC,182,281,289,370,1,107,89,235,325,0.3671875,0.6770833333333334,0.1671875,0.18541666666666667
BloodImage_00331.jpg,292.jpg,RBC,180,279,287,368,1,107,89,233,323,0.3640625,0.6729166666666667,0.1671875,0.18541666666666667
BloodImage_00331.jpg,292.jpg,RBC,343,199,456,310,1,113,111,399,254,0.6234375,0.5291666666666667,0.1765625,0.23125
BloodImage_00331.jpg,292.jpg,RBC,424,277,549,379,1,125,102,486,328,0.759375,0.6833333333333333,0.1953125,0.2125
BloodImage_00331.jpg,292.jpg,RBC,180,106,282,210,1,102,104,231,158,0.3609375,0.32916666666666666,0.159375,0.21666666666666667
BloodImage_00331.jpg,292.jpg,RBC,238,352,329,451,1,91,99,283,401,0.4421875,0.8354166666666667,0.1421875,0.20625
BloodImage_00331.jpg,292.jpg,RBC,333,316,457,438,1,124,122,395,377,0.6171875,0.7854166666666667,0.19375,0.25416666666666665
BloodImage_00331.jpg,292.jpg,RBC,436,107,520,208,1,84,101,478,157,0.746875,0.32708333333333334,0.13125,0.21041666666666667
BloodImage_00331.jpg,292.jpg,RBC,1,77,105,178,1,104,101,53,127,0.0828125,0.26458333333333334,0.1625,0.21041666666666667
BloodImage_00331.jpg,292.jpg,RBC,1,157,82,264,1,81,107,41,210,0.0640625,0.4375,0.1265625,0.22291666666666668
BloodImage_00331.jpg,292.jpg,RBC,23,250,140,351,1,117,101,81,300,0.1265625,0.625,0.1828125,0.21041666666666667
BloodImage_00331.jpg,292.jpg,RBC,516,70,628,168,1,112,98,572,119,0.89375,0.24791666666666667,0.175,0.20416666666666666
BloodImage_00331.jpg,292.jpg,RBC,144,20,253,123,1,109,103,198,71,0.309375,0.14791666666666667,0.1703125,0.21458333333333332
BloodImage_00331.jpg,292.jpg,WBC,244,1,459,196,2,215,195,351,98,0.5484375,0.20416666666666666,0.3359375,0.40625
BloodImage_00332.jpg,293.jpg,RBC,146,267,241,371,1,95,104,193,319,0.3015625,0.6645833333333333,0.1484375,0.21666666666666667
BloodImage_00332.jpg,293.jpg,RBC,44,253,152,359,1,108,106,98,306,0.153125,0.6375,0.16875,0.22083333333333333
BloodImage_00332.jpg,293.jpg,RBC,149,124,257,230,1,108,106,203,177,0.3171875,0.36875,0.16875,0.22083333333333333
BloodImage_00332.jpg,293.jpg,RBC,440,296,550,414,1,110,118,495,355,0.7734375,0.7395833333333334,0.171875,0.24583333333333332
BloodImage_00332.jpg,293.jpg,RBC,269,104,379,222,1,110,118,324,163,0.50625,0.33958333333333335,0.171875,0.24583333333333332
BloodImage_00332.jpg,293.jpg,RBC,530,107,639,200,1,109,93,584,153,0.9125,0.31875,0.1703125,0.19375
BloodImage_00332.jpg,293.jpg,RBC,518,173,627,283,1,109,110,572,228,0.89375,0.475,0.1703125,0.22916666666666666
BloodImage_00332.jpg,293.jpg,RBC,531,31,640,130,1,109,99,585,80,0.9140625,0.16666666666666666,0.1703125,0.20625
BloodImage_00332.jpg,293.jpg,RBC,269,6,376,108,1,107,102,322,57,0.503125,0.11875,0.1671875,0.2125
BloodImage_00332.jpg,293.jpg,WBC,228,204,445,433,2,217,229,336,318,0.525,0.6625,0.3390625,0.47708333333333336
BloodImage_00333.jpg,294.jpg,RBC,183,144,260,287,1,77,143,221,215,0.3453125,0.4479166666666667,0.1203125,0.29791666666666666
BloodImage_00333.jpg,294.jpg,RBC,129,40,249,141,1,120,101,189,90,0.2953125,0.1875,0.1875,0.21041666666666667
BloodImage_00333.jpg,294.jpg,RBC,86,153,181,244,1,95,91,133,198,0.2078125,0.4125,0.1484375,0.18958333333333333
BloodImage_00333.jpg,294.jpg,RBC,56,233,164,332,1,108,99,110,282,0.171875,0.5875,0.16875,0.20625
BloodImage_00333.jpg,294.jpg,RBC,205,313,319,425,1,114,112,262,369,0.409375,0.76875,0.178125,0.23333333333333334
BloodImage_00333.jpg,294.jpg,RBC,256,211,362,309,1,106,98,309,260,0.4828125,0.5416666666666666,0.165625,0.20416666666666666
BloodImage_00333.jpg,294.jpg,RBC,335,149,454,246,1,119,97,394,197,0.615625,0.41041666666666665,0.1859375,0.20208333333333334
BloodImage_00333.jpg,294.jpg,RBC,10,329,125,453,1,115,124,67,391,0.1046875,0.8145833333333333,0.1796875,0.25833333333333336
BloodImage_00333.jpg,294.jpg,RBC,1,79,110,187,1,109,108,55,133,0.0859375,0.27708333333333335,0.1703125,0.225
BloodImage_00333.jpg,294.jpg,RBC,334,40,426,152,1,92,112,380,96,0.59375,0.2,0.14375,0.23333333333333334
BloodImage_00333.jpg,294.jpg,RBC,376,31,500,152,1,124,121,438,91,0.684375,0.18958333333333333,0.19375,0.2520833333333333
BloodImage_00333.jpg,294.jpg,RBC,498,257,603,361,1,105,104,550,309,0.859375,0.64375,0.1640625,0.21666666666666667
BloodImage_00333.jpg,294.jpg,RBC,511,322,607,414,1,96,92,559,368,0.8734375,0.7666666666666667,0.15,0.19166666666666668
BloodImage_00333.jpg,294.jpg,RBC,474,121,571,210,1,97,89,522,165,0.815625,0.34375,0.1515625,0.18541666666666667
BloodImage_00333.jpg,294.jpg,WBC,295,267,518,472,2,223,205,406,369,0.634375,0.76875,0.3484375,0.4270833333333333
BloodImage_00333.jpg,294.jpg,Platelets,290,89,321,119,0,31,30,305,104,0.4765625,0.21666666666666667,0.0484375,0.0625
BloodImage_00333.jpg,294.jpg,Platelets,479,440,504,477,0,25,37,491,458,0.7671875,0.9541666666666667,0.0390625,0.07708333333333334
BloodImage_00334.jpg,295.jpg,RBC,201,300,295,392,1,94,92,248,346,0.3875,0.7208333333333333,0.146875,0.19166666666666668
BloodImage_00334.jpg,295.jpg,RBC,301,346,382,439,1,81,93,341,392,0.5328125,0.8166666666666667,0.1265625,0.19375
BloodImage_00334.jpg,295.jpg,RBC,535,199,640,312,1,105,113,587,255,0.9171875,0.53125,0.1640625,0.23541666666666666
BloodImage_00334.jpg,295.jpg,RBC,131,100,272,213,1,141,113,201,156,0.3140625,0.325,0.2203125,0.23541666666666666
BloodImage_00334.jpg,295.jpg,RBC,35,254,167,368,1,132,114,101,311,0.1578125,0.6479166666666667,0.20625,0.2375
BloodImage_00334.jpg,295.jpg,RBC,493,385,610,480,1,117,95,551,432,0.8609375,0.9,0.1828125,0.19791666666666666
BloodImage_00334.jpg,295.jpg,RBC,313,31,445,125,1,132,94,379,78,0.5921875,0.1625,0.20625,0.19583333333333333
BloodImage_00334.jpg,295.jpg,RBC,104,383,211,480,1,107,97,157,431,0.2453125,0.8979166666666667,0.1671875,0.20208333333333334
BloodImage_00334.jpg,295.jpg,RBC,472,114,580,213,1,108,99,526,163,0.821875,0.33958333333333335,0.16875,0.20625
BloodImage_00334.jpg,295.jpg,RBC,548,310,640,411,1,92,101,594,360,0.928125,0.75,0.14375,0.21041666666666667
BloodImage_00334.jpg,295.jpg,WBC,236,126,453,355,2,217,229,344,240,0.5375,0.5,0.3390625,0.47708333333333336
BloodImage_00335.jpg,296.jpg,RBC,220,222,326,315,1,106,93,273,268,0.4265625,0.5583333333333333,0.165625,0.19375
BloodImage_00335.jpg,296.jpg,RBC,363,4,471,122,1,108,118,417,63,0.6515625,0.13125,0.16875,0.24583333333333332
BloodImage_00335.jpg,296.jpg,RBC,422,150,507,252,1,85,102,464,201,0.725,0.41875,0.1328125,0.2125
BloodImage_00335.jpg,296.jpg,RBC,256,4,362,109,1,106,105,309,56,0.4828125,0.11666666666666667,0.165625,0.21875
BloodImage_00335.jpg,296.jpg,RBC,116,128,261,238,1,145,110,188,183,0.29375,0.38125,0.2265625,0.22916666666666666
BloodImage_00335.jpg,296.jpg,RBC,379,288,494,390,1,115,102,436,339,0.68125,0.70625,0.1796875,0.2125
BloodImage_00335.jpg,296.jpg,RBC,86,232,163,309,1,77,77,124,270,0.19375,0.5625,0.1203125,0.16041666666666668
BloodImage_00335.jpg,296.jpg,RBC,62,376,161,470,1,99,94,111,423,0.1734375,0.88125,0.1546875,0.19583333333333333
BloodImage_00335.jpg,296.jpg,RBC,101,29,210,141,1,109,112,155,85,0.2421875,0.17708333333333334,0.1703125,0.23333333333333334
BloodImage_00335.jpg,296.jpg,RBC,250,126,358,227,1,108,101,304,176,0.475,0.36666666666666664,0.16875,0.21041666666666667
BloodImage_00335.jpg,296.jpg,RBC,175,368,272,480,1,97,112,223,424,0.3484375,0.8833333333333333,0.1515625,0.23333333333333334
BloodImage_00335.jpg,296.jpg,WBC,265,334,490,480,2,225,146,377,407,0.5890625,0.8479166666666667,0.3515625,0.30416666666666664
BloodImage_00336.jpg,297.jpg,RBC,62,73,165,175,1,103,102,113,124,0.1765625,0.25833333333333336,0.1609375,0.2125
BloodImage_00336.jpg,297.jpg,RBC,236,216,345,348,1,109,132,290,282,0.453125,0.5875,0.1703125,0.275
BloodImage_00336.jpg,297.jpg,RBC,129,300,229,396,1,100,96,179,348,0.2796875,0.725,0.15625,0.2
BloodImage_00336.jpg,297.jpg,RBC,365,306,494,425,1,129,119,429,365,0.6703125,0.7604166666666666,0.2015625,0.24791666666666667
BloodImage_00336.jpg,297.jpg,RBC,494,36,593,138,1,99,102,543,87,0.8484375,0.18125,0.1546875,0.2125
BloodImage_00336.jpg,297.jpg,RBC,177,25,273,132,1,96,107,225,78,0.3515625,0.1625,0.15,0.22291666666666668
BloodImage_00336.jpg,297.jpg,RBC,64,192,182,284,1,118,92,123,238,0.1921875,0.49583333333333335,0.184375,0.19166666666666668
BloodImage_00336.jpg,297.jpg,RBC,45,368,146,446,1,101,78,95,407,0.1484375,0.8479166666666667,0.1578125,0.1625
BloodImage_00336.jpg,297.jpg,RBC,528,289,632,389,1,104,100,580,339,0.90625,0.70625,0.1625,0.20833333333333334
BloodImage_00336.jpg,297.jpg,RBC,57,254,225,325,1,168,71,141,289,0.2203125,0.6020833333333333,0.2625,0.14791666666666667
BloodImage_00336.jpg,297.jpg,WBC,280,43,507,236,2,227,193,393,139,0.6140625,0.28958333333333336,0.3546875,0.40208333333333335
BloodImage_00337.jpg,298.jpg,RBC,395,222,495,322,1,100,100,445,272,0.6953125,0.5666666666666667,0.15625,0.20833333333333334
BloodImage_00337.jpg,298.jpg,RBC,47,116,138,212,1,91,96,92,164,0.14375,0.3416666666666667,0.1421875,0.2
BloodImage_00337.jpg,298.jpg,RBC,140,105,221,211,1,81,106,180,158,0.28125,0.32916666666666666,0.1265625,0.22083333333333333
BloodImage_00337.jpg,298.jpg,RBC,83,372,177,456,1,94,84,130,414,0.203125,0.8625,0.146875,0.175
BloodImage_00337.jpg,298.jpg,RBC,469,272,518,419,1,49,147,493,345,0.7703125,0.71875,0.0765625,0.30625
BloodImage_00337.jpg,298.jpg,RBC,535,289,631,383,1,96,94,583,336,0.9109375,0.7,0.15,0.19583333333333333
BloodImage_00337.jpg,298.jpg,RBC,353,309,474,416,1,121,107,413,362,0.6453125,0.7541666666666667,0.1890625,0.22291666666666668
BloodImage_00337.jpg,298.jpg,RBC,483,96,577,186,1,94,90,530,141,0.828125,0.29375,0.146875,0.1875
BloodImage_00337.jpg,298.jpg,RBC,529,87,628,173,1,99,86,578,130,0.903125,0.2708333333333333,0.1546875,0.17916666666666667
BloodImage_00337.jpg,298.jpg,RBC,357,67,451,164,1,94,97,404,115,0.63125,0.23958333333333334,0.146875,0.20208333333333334
BloodImage_00337.jpg,298.jpg,RBC,19,257,105,352,1,86,95,62,304,0.096875,0.6333333333333333,0.134375,0.19791666666666666
BloodImage_00337.jpg,298.jpg,RBC,11,305,102,397,1,91,92,56,351,0.0875,0.73125,0.1421875,0.19166666666666668
BloodImage_00337.jpg,298.jpg,RBC,283,102,358,206,1,75,104,320,154,0.5,0.32083333333333336,0.1171875,0.21666666666666667
BloodImage_00337.jpg,298.jpg,WBC,127,251,343,439,2,216,188,235,345,0.3671875,0.71875,0.3375,0.39166666666666666
BloodImage_00338.jpg,299.jpg,RBC,453,81,555,182,1,102,101,504,131,0.7875,0.27291666666666664,0.159375,0.21041666666666667
BloodImage_00338.jpg,299.jpg,RBC,476,171,599,307,1,123,136,537,239,0.8390625,0.4979166666666667,0.1921875,0.2833333333333333
BloodImage_00338.jpg,299.jpg,RBC,346,212,455,316,1,109,104,400,264,0.625,0.55,0.1703125,0.21666666666666667
BloodImage_00338.jpg,299.jpg,RBC,24,113,127,207,1,103,94,75,160,0.1171875,0.3333333333333333,0.1609375,0.19583333333333333
BloodImage_00338.jpg,299.jpg,RBC,163,31,289,131,1,126,100,226,81,0.353125,0.16875,0.196875,0.20833333333333334
BloodImage_00338.jpg,299.jpg,RBC,83,303,175,382,1,92,79,129,342,0.2015625,0.7125,0.14375,0.16458333333333333
BloodImage_00338.jpg,299.jpg,RBC,304,64,413,174,1,109,110,358,119,0.559375,0.24791666666666667,0.1703125,0.22916666666666666
BloodImage_00338.jpg,299.jpg,RBC,60,61,153,157,1,93,96,106,109,0.165625,0.22708333333333333,0.1453125,0.2
BloodImage_00338.jpg,299.jpg,RBC,174,321,265,406,1,91,85,219,363,0.3421875,0.75625,0.1421875,0.17708333333333334
BloodImage_00338.jpg,299.jpg,RBC,191,164,292,245,1,101,81,241,204,0.3765625,0.425,0.1578125,0.16875
BloodImage_00338.jpg,299.jpg,RBC,91,181,190,276,1,99,95,140,228,0.21875,0.475,0.1546875,0.19791666666666666
BloodImage_00338.jpg,299.jpg,RBC,169,202,263,278,1,94,76,216,240,0.3375,0.5,0.146875,0.15833333333333333
BloodImage_00338.jpg,299.jpg,RBC,504,337,504,337,1,0,0,504,337,0.7875,0.7020833333333333,0.0,0.0
BloodImage_00338.jpg,299.jpg,WBC,244,327,509,480,2,265,153,376,403,0.5875,0.8395833333333333,0.4140625,0.31875
BloodImage_00339.jpg,300.jpg,RBC,378,278,489,374,1,111,96,433,326,0.6765625,0.6791666666666667,0.1734375,0.2
BloodImage_00339.jpg,300.jpg,RBC,448,67,580,177,1,132,110,514,122,0.803125,0.25416666666666665,0.20625,0.22916666666666666
BloodImage_00339.jpg,300.jpg,RBC,308,23,409,145,1,101,122,358,84,0.559375,0.175,0.1578125,0.25416666666666665
BloodImage_00339.jpg,300.jpg,RBC,10,220,117,337,1,107,117,63,278,0.0984375,0.5791666666666667,0.1671875,0.24375
BloodImage_00339.jpg,300.jpg,RBC,65,190,181,319,1,116,129,123,254,0.1921875,0.5291666666666667,0.18125,0.26875
BloodImage_00339.jpg,300.jpg,RBC,171,66,279,185,1,108,119,225,125,0.3515625,0.2604166666666667,0.16875,0.24791666666666667
BloodImage_00339.jpg,300.jpg,RBC,136,329,259,442,1,123,113,197,385,0.3078125,0.8020833333333334,0.1921875,0.23541666666666666
BloodImage_00339.jpg,300.jpg,RBC,229,322,350,414,1,121,92,289,368,0.4515625,0.7666666666666667,0.1890625,0.19166666666666668
BloodImage_00339.jpg,300.jpg,RBC,25,368,160,477,1,135,109,92,422,0.14375,0.8791666666666667,0.2109375,0.22708333333333333
BloodImage_00339.jpg,300.jpg,RBC,370,382,489,477,1,119,95,429,429,0.6703125,0.89375,0.1859375,0.19791666666666666
BloodImage_00339.jpg,300.jpg,RBC,525,8,638,93,1,113,85,581,50,0.9078125,0.10416666666666667,0.1765625,0.17708333333333334
BloodImage_00339.jpg,300.jpg,RBC,20,28,141,147,1,121,119,80,87,0.125,0.18125,0.1890625,0.24791666666666667
BloodImage_00339.jpg,300.jpg,RBC,510,259,608,359,1,98,100,559,309,0.8734375,0.64375,0.153125,0.20833333333333334
BloodImage_00339.jpg,300.jpg,RBC,566,152,640,265,1,74,113,603,208,0.9421875,0.43333333333333335,0.115625,0.23541666666666666
BloodImage_00339.jpg,300.jpg,RBC,424,163,581,278,1,157,115,502,220,0.784375,0.4583333333333333,0.2453125,0.23958333333333334
BloodImage_00339.jpg,300.jpg,WBC,185,127,447,338,2,262,211,316,232,0.49375,0.48333333333333334,0.409375,0.4395833333333333
BloodImage_00339.jpg,300.jpg,Platelets,320,398,360,443,0,40,45,340,420,0.53125,0.875,0.0625,0.09375
BloodImage_00339.jpg,300.jpg,Platelets,127,79,183,128,0,56,49,155,103,0.2421875,0.21458333333333332,0.0875,0.10208333333333333
BloodImage_00340.jpg,301.jpg,RBC,307,247,424,357,1,117,110,365,302,0.5703125,0.6291666666666667,0.1828125,0.22916666666666666
BloodImage_00340.jpg,301.jpg,RBC,401,44,531,158,1,130,114,466,101,0.728125,0.21041666666666667,0.203125,0.2375
BloodImage_00340.jpg,301.jpg,RBC,162,51,279,166,1,117,115,220,108,0.34375,0.225,0.1828125,0.23958333333333334
BloodImage_00340.jpg,301.jpg,RBC,56,93,171,213,1,115,120,113,153,0.1765625,0.31875,0.1796875,0.25
BloodImage_00340.jpg,301.jpg,RBC,47,191,169,313,1,122,122,108,252,0.16875,0.525,0.190625,0.25416666666666665
BloodImage_00340.jpg,301.jpg,RBC,119,326,245,419,1,126,93,182,372,0.284375,0.775,0.196875,0.19375
BloodImage_00340.jpg,301.jpg,RBC,228,153,348,267,1,120,114,288,210,0.45,0.4375,0.1875,0.2375
BloodImage_00340.jpg,301.jpg,RBC,152,225,284,326,1,132,101,218,275,0.340625,0.5729166666666666,0.20625,0.21041666666666667
BloodImage_00340.jpg,301.jpg,RBC,436,170,539,269,1,103,99,487,219,0.7609375,0.45625,0.1609375,0.20625
BloodImage_00340.jpg,301.jpg,RBC,296,1,421,73,1,125,72,358,37,0.559375,0.07708333333333334,0.1953125,0.15
BloodImage_00340.jpg,301.jpg,RBC,491,150,580,277,1,89,127,535,213,0.8359375,0.44375,0.1390625,0.26458333333333334
BloodImage_00340.jpg,301.jpg,WBC,239,356,470,480,2,231,124,354,418,0.553125,0.8708333333333333,0.3609375,0.25833333333333336
BloodImage_00341.jpg,302.jpg,RBC,146,180,251,296,1,105,116,198,238,0.309375,0.49583333333333335,0.1640625,0.24166666666666667
BloodImage_00341.jpg,302.jpg,RBC,49,276,179,378,1,130,102,114,327,0.178125,0.68125,0.203125,0.2125
BloodImage_00341.jpg,302.jpg,RBC,33,129,153,248,1,120,119,93,188,0.1453125,0.39166666666666666,0.1875,0.24791666666666667
BloodImage_00341.jpg,302.jpg,RBC,58,45,175,141,1,117,96,116,93,0.18125,0.19375,0.1828125,0.2
BloodImage_00341.jpg,302.jpg,RBC,267,292,355,405,1,88,113,311,348,0.4859375,0.725,0.1375,0.23541666666666666
BloodImage_00341.jpg,302.jpg,RBC,152,322,265,428,1,113,106,208,375,0.325,0.78125,0.1765625,0.22083333333333333
BloodImage_00341.jpg,302.jpg,RBC,325,1,462,104,1,137,103,393,52,0.6140625,0.10833333333333334,0.2140625,0.21458333333333332
BloodImage_00341.jpg,302.jpg,RBC,53,390,160,477,1,107,87,106,433,0.165625,0.9020833333333333,0.1671875,0.18125
BloodImage_00341.jpg,302.jpg,RBC,347,340,469,436,1,122,96,408,388,0.6375,0.8083333333333333,0.190625,0.2
BloodImage_00341.jpg,302.jpg,WBC,356,70,582,317,2,226,247,469,193,0.7328125,0.40208333333333335,0.353125,0.5145833333333333
BloodImage_00342.jpg,303.jpg,RBC,316,11,426,121,1,110,110,371,66,0.5796875,0.1375,0.171875,0.22916666666666666
BloodImage_00342.jpg,303.jpg,RBC,470,100,580,210,1,110,110,525,155,0.8203125,0.3229166666666667,0.171875,0.22916666666666666
BloodImage_00342.jpg,303.jpg,RBC,58,69,138,178,1,80,109,98,123,0.153125,0.25625,0.125,0.22708333333333333
BloodImage_00342.jpg,303.jpg,RBC,425,220,526,328,1,101,108,475,274,0.7421875,0.5708333333333333,0.1578125,0.225
BloodImage_00342.jpg,303.jpg,RBC,74,324,192,422,1,118,98,133,373,0.2078125,0.7770833333333333,0.184375,0.20416666666666666
BloodImage_00342.jpg,303.jpg,RBC,203,1,302,72,1,99,71,252,36,0.39375,0.075,0.1546875,0.14791666666666667
BloodImage_00342.jpg,303.jpg,RBC,492,413,578,480,1,86,67,535,446,0.8359375,0.9291666666666667,0.134375,0.13958333333333334
BloodImage_00342.jpg,303.jpg,RBC,322,256,440,366,1,118,110,381,311,0.5953125,0.6479166666666667,0.184375,0.22916666666666666
BloodImage_00342.jpg,303.jpg,WBC,111,106,420,362,2,309,256,265,234,0.4140625,0.4875,0.4828125,0.5333333333333333
BloodImage_00343.jpg,304.jpg,RBC,484,195,613,303,1,129,108,548,249,0.85625,0.51875,0.2015625,0.225
BloodImage_00343.jpg,304.jpg,RBC,525,299,637,396,1,112,97,581,347,0.9078125,0.7229166666666667,0.175,0.20208333333333334
BloodImage_00343.jpg,304.jpg,RBC,96,157,227,244,1,131,87,161,200,0.2515625,0.4166666666666667,0.2046875,0.18125
BloodImage_00343.jpg,304.jpg,RBC,181,329,181,329,1,0,0,181,329,0.2828125,0.6854166666666667,0.0,0.0
BloodImage_00343.jpg,304.jpg,RBC,256,200,376,307,1,120,107,316,253,0.49375,0.5270833333333333,0.1875,0.22291666666666668
BloodImage_00343.jpg,304.jpg,RBC,523,1,640,119,1,117,118,581,60,0.9078125,0.125,0.1828125,0.24583333333333332
BloodImage_00343.jpg,304.jpg,RBC,32,5,133,98,1,101,93,82,51,0.128125,0.10625,0.1578125,0.19375
BloodImage_00343.jpg,304.jpg,RBC,132,22,201,145,1,69,123,166,83,0.259375,0.17291666666666666,0.1078125,0.25625
BloodImage_00343.jpg,304.jpg,RBC,338,325,429,444,1,91,119,383,384,0.5984375,0.8,0.1421875,0.24791666666666667
BloodImage_00343.jpg,304.jpg,Platelets,1,361,48,410,0,47,49,24,385,0.0375,0.8020833333333334,0.0734375,0.10208333333333333
BloodImage_00343.jpg,304.jpg,Platelets,70,206,118,255,0,48,49,94,230,0.146875,0.4791666666666667,0.075,0.10208333333333333
BloodImage_00343.jpg,304.jpg,WBC,183,1,425,153,2,242,152,304,77,0.475,0.16041666666666668,0.378125,0.31666666666666665
BloodImage_00344.jpg,305.jpg,RBC,529,174,618,260,1,89,86,573,217,0.8953125,0.45208333333333334,0.1390625,0.17916666666666667
BloodImage_00344.jpg,305.jpg,RBC,347,290,449,407,1,102,117,398,348,0.621875,0.725,0.159375,0.24375
BloodImage_00344.jpg,305.jpg,RBC,4,347,100,437,1,96,90,52,392,0.08125,0.8166666666666667,0.15,0.1875
BloodImage_00344.jpg,305.jpg,RBC,383,413,516,478,1,133,65,449,445,0.7015625,0.9270833333333334,0.2078125,0.13541666666666666
BloodImage_00344.jpg,305.jpg,RBC,254,391,372,480,1,118,89,313,435,0.4890625,0.90625,0.184375,0.18541666666666667
BloodImage_00344.jpg,305.jpg,RBC,246,297,353,401,1,107,104,299,349,0.4671875,0.7270833333333333,0.1671875,0.21666666666666667
BloodImage_00344.jpg,305.jpg,RBC,347,1,483,104,1,136,103,415,52,0.6484375,0.10833333333333334,0.2125,0.21458333333333332
BloodImage_00344.jpg,305.jpg,RBC,505,362,616,455,1,111,93,560,408,0.875,0.85,0.1734375,0.19375
BloodImage_00344.jpg,305.jpg,RBC,41,12,129,149,1,88,137,85,80,0.1328125,0.16666666666666666,0.1375,0.28541666666666665
BloodImage_00344.jpg,305.jpg,RBC,318,117,441,213,1,123,96,379,165,0.5921875,0.34375,0.1921875,0.2
BloodImage_00344.jpg,305.jpg,RBC,30,236,147,329,1,117,93,88,282,0.1375,0.5875,0.1828125,0.19375
BloodImage_00344.jpg,305.jpg,RBC,84,321,192,413,1,108,92,138,367,0.215625,0.7645833333333333,0.16875,0.19166666666666668
BloodImage_00344.jpg,305.jpg,Platelets,28,183,81,226,0,53,43,54,204,0.084375,0.425,0.0828125,0.08958333333333333
BloodImage_00344.jpg,305.jpg,WBC,74,108,336,359,2,262,251,205,233,0.3203125,0.48541666666666666,0.409375,0.5229166666666667
BloodImage_00345.jpg,306.jpg,RBC,203,266,335,392,1,132,126,269,329,0.4203125,0.6854166666666667,0.20625,0.2625
BloodImage_00345.jpg,306.jpg,RBC,477,253,561,339,1,84,86,519,296,0.8109375,0.6166666666666667,0.13125,0.17916666666666667
BloodImage_00345.jpg,306.jpg,RBC,375,290,481,380,1,106,90,428,335,0.66875,0.6979166666666666,0.165625,0.1875
BloodImage_00345.jpg,306.jpg,RBC,392,152,488,232,1,96,80,440,192,0.6875,0.4,0.15,0.16666666666666666
BloodImage_00345.jpg,306.jpg,RBC,277,178,387,266,1,110,88,332,222,0.51875,0.4625,0.171875,0.18333333333333332
BloodImage_00345.jpg,306.jpg,RBC,183,76,275,169,1,92,93,229,122,0.3578125,0.25416666666666665,0.14375,0.19375
BloodImage_00345.jpg,306.jpg,RBC,64,48,172,159,1,108,111,118,103,0.184375,0.21458333333333332,0.16875,0.23125
BloodImage_00345.jpg,306.jpg,RBC,286,19,404,121,1,118,102,345,70,0.5390625,0.14583333333333334,0.184375,0.2125
BloodImage_00345.jpg,306.jpg,RBC,452,51,565,159,1,113,108,508,105,0.79375,0.21875,0.1765625,0.225
BloodImage_00345.jpg,306.jpg,RBC,78,279,178,371,1,100,92,128,325,0.2,0.6770833333333334,0.15625,0.19166666666666668
BloodImage_00345.jpg,306.jpg,RBC,40,166,148,281,1,108,115,94,223,0.146875,0.46458333333333335,0.16875,0.23958333333333334
BloodImage_00345.jpg,306.jpg,RBC,305,367,414,474,1,109,107,359,420,0.5609375,0.875,0.1703125,0.22291666666666668
BloodImage_00345.jpg,306.jpg,WBC,402,321,639,480,2,237,159,520,400,0.8125,0.8333333333333334,0.3703125,0.33125
BloodImage_00346.jpg,307.jpg,RBC,403,68,502,168,1,99,100,452,118,0.70625,0.24583333333333332,0.1546875,0.20833333333333334
BloodImage_00346.jpg,307.jpg,RBC,138,201,245,303,1,107,102,191,252,0.2984375,0.525,0.1671875,0.2125
BloodImage_00346.jpg,307.jpg,RBC,288,105,370,200,1,82,95,329,152,0.5140625,0.31666666666666665,0.128125,0.19791666666666666
BloodImage_00346.jpg,307.jpg,RBC,320,157,425,278,1,105,121,372,217,0.58125,0.45208333333333334,0.1640625,0.2520833333333333
BloodImage_00346.jpg,307.jpg,RBC,222,40,309,143,1,87,103,265,91,0.4140625,0.18958333333333333,0.1359375,0.21458333333333332
BloodImage_00346.jpg,307.jpg,RBC,409,244,536,354,1,127,110,472,299,0.7375,0.6229166666666667,0.1984375,0.22916666666666666
BloodImage_00346.jpg,307.jpg,RBC,489,99,616,219,1,127,120,552,159,0.8625,0.33125,0.1984375,0.25
BloodImage_00346.jpg,307.jpg,RBC,35,156,168,234,1,133,78,101,195,0.1578125,0.40625,0.2078125,0.1625
BloodImage_00346.jpg,307.jpg,RBC,16,365,117,459,1,101,94,66,412,0.103125,0.8583333333333333,0.1578125,0.19583333333333333
BloodImage_00346.jpg,307.jpg,RBC,36,1,121,86,1,85,85,78,43,0.121875,0.08958333333333333,0.1328125,0.17708333333333334
BloodImage_00346.jpg,307.jpg,RBC,138,45,238,159,1,100,114,188,102,0.29375,0.2125,0.15625,0.2375
BloodImage_00346.jpg,307.jpg,RBC,319,1,432,79,1,113,78,375,40,0.5859375,0.08333333333333333,0.1765625,0.1625
BloodImage_00346.jpg,307.jpg,RBC,566,348,640,463,1,74,115,603,405,0.9421875,0.84375,0.115625,0.23958333333333334
BloodImage_00346.jpg,307.jpg,WBC,162,274,399,480,2,237,206,280,377,0.4375,0.7854166666666667,0.3703125,0.42916666666666664
BloodImage_00347.jpg,308.jpg,RBC,109,196,225,295,1,116,99,167,245,0.2609375,0.5104166666666666,0.18125,0.20625
BloodImage_00347.jpg,308.jpg,RBC,176,296,277,400,1,101,104,226,348,0.353125,0.725,0.1578125,0.21666666666666667
BloodImage_00347.jpg,308.jpg,RBC,116,309,208,399,1,92,90,162,354,0.253125,0.7375,0.14375,0.1875
BloodImage_00347.jpg,308.jpg,RBC,187,1,302,108,1,115,107,244,54,0.38125,0.1125,0.1796875,0.22291666666666668
BloodImage_00347.jpg,308.jpg,RBC,451,350,553,454,1,102,104,502,402,0.784375,0.8375,0.159375,0.21666666666666667
BloodImage_00347.jpg,308.jpg,RBC,456,173,563,284,1,107,111,509,228,0.7953125,0.475,0.1671875,0.23125
BloodImage_00347.jpg,308.jpg,RBC,439,225,545,327,1,106,102,492,276,0.76875,0.575,0.165625,0.2125
BloodImage_00347.jpg,308.jpg,RBC,261,129,371,224,1,110,95,316,176,0.49375,0.36666666666666664,0.171875,0.19791666666666666
BloodImage_00347.jpg,308.jpg,RBC,560,72,640,190,1,80,118,600,131,0.9375,0.27291666666666664,0.125,0.24583333333333332
BloodImage_00347.jpg,308.jpg,RBC,538,1,639,69,1,101,68,588,35,0.91875,0.07291666666666667,0.1578125,0.14166666666666666
BloodImage_00347.jpg,308.jpg,RBC,450,1,551,69,1,101,68,500,35,0.78125,0.07291666666666667,0.1578125,0.14166666666666666
BloodImage_00347.jpg,308.jpg,RBC,327,1,428,92,1,101,91,377,46,0.5890625,0.09583333333333334,0.1578125,0.18958333333333333
BloodImage_00347.jpg,308.jpg,RBC,421,64,520,161,1,99,97,470,112,0.734375,0.23333333333333334,0.1546875,0.20208333333333334
BloodImage_00347.jpg,308.jpg,RBC,228,109,327,206,1,99,97,277,157,0.4328125,0.32708333333333334,0.1546875,0.20208333333333334
BloodImage_00347.jpg,308.jpg,RBC,72,45,171,142,1,99,97,121,93,0.1890625,0.19375,0.1546875,0.20208333333333334
BloodImage_00347.jpg,308.jpg,RBC,17,245,124,356,1,107,111,70,300,0.109375,0.625,0.1671875,0.23125
BloodImage_00347.jpg,308.jpg,RBC,255,233,356,305,1,101,72,305,269,0.4765625,0.5604166666666667,0.1578125,0.15
BloodImage_00347.jpg,308.jpg,RBC,552,233,640,337,1,88,104,596,285,0.93125,0.59375,0.1375,0.21666666666666667
BloodImage_00347.jpg,308.jpg,WBC,319,297,476,453,2,157,156,397,375,0.6203125,0.78125,0.2453125,0.325
BloodImage_00348.jpg,309.jpg,RBC,214,350,310,453,1,96,103,262,401,0.409375,0.8354166666666667,0.15,0.21458333333333332
BloodImage_00348.jpg,309.jpg,RBC,439,294,524,382,1,85,88,481,338,0.7515625,0.7041666666666667,0.1328125,0.18333333333333332
BloodImage_00348.jpg,309.jpg,RBC,103,220,224,322,1,121,102,163,271,0.2546875,0.5645833333333333,0.1890625,0.2125
BloodImage_00348.jpg,309.jpg,RBC,273,214,389,303,1,116,89,331,258,0.5171875,0.5375,0.18125,0.18541666666666667
BloodImage_00348.jpg,309.jpg,RBC,525,283,630,368,1,105,85,577,325,0.9015625,0.6770833333333334,0.1640625,0.17708333333333334
BloodImage_00348.jpg,309.jpg,RBC,504,395,619,480,1,115,85,561,437,0.8765625,0.9104166666666667,0.1796875,0.17708333333333334
BloodImage_00348.jpg,309.jpg,RBC,93,413,204,480,1,111,67,148,446,0.23125,0.9291666666666667,0.1734375,0.13958333333333334
BloodImage_00348.jpg,309.jpg,RBC,7,353,125,440,1,118,87,66,396,0.103125,0.825,0.184375,0.18125
BloodImage_00348.jpg,309.jpg,RBC,373,116,470,221,1,97,105,421,168,0.6578125,0.35,0.1515625,0.21875
BloodImage_00348.jpg,309.jpg,RBC,464,122,551,229,1,87,107,507,175,0.7921875,0.3645833333333333,0.1359375,0.22291666666666668
BloodImage_00348.jpg,309.jpg,RBC,288,84,375,191,1,87,107,331,137,0.5171875,0.28541666666666665,0.1359375,0.22291666666666668
BloodImage_00348.jpg,309.jpg,RBC,335,273,445,366,1,110,93,390,319,0.609375,0.6645833333333333,0.171875,0.19375
BloodImage_00348.jpg,309.jpg,RBC,569,195,640,286,1,71,91,604,240,0.94375,0.5,0.1109375,0.18958333333333333
BloodImage_00348.jpg,309.jpg,RBC,395,389,508,480,1,113,91,451,434,0.7046875,0.9041666666666667,0.1765625,0.18958333333333333
BloodImage_00348.jpg,309.jpg,WBC,62,7,294,225,2,232,218,178,116,0.278125,0.24166666666666667,0.3625,0.45416666666666666
BloodImage_00349.jpg,310.jpg,RBC,400,48,497,176,1,97,128,448,112,0.7,0.23333333333333334,0.1515625,0.26666666666666666
BloodImage_00349.jpg,310.jpg,RBC,520,188,621,293,1,101,105,570,240,0.890625,0.5,0.1578125,0.21875
BloodImage_00349.jpg,310.jpg,RBC,470,1,577,88,1,107,87,523,44,0.8171875,0.09166666666666666,0.1671875,0.18125
BloodImage_00349.jpg,310.jpg,RBC,139,179,247,275,1,108,96,193,227,0.3015625,0.47291666666666665,0.16875,0.2
BloodImage_00349.jpg,310.jpg,RBC,194,348,303,462,1,109,114,248,405,0.3875,0.84375,0.1703125,0.2375
BloodImage_00349.jpg,310.jpg,RBC,344,362,446,454,1,102,92,395,408,0.6171875,0.85,0.159375,0.19166666666666668
BloodImage_00349.jpg,310.jpg,RBC,134,270,242,366,1,108,96,188,318,0.29375,0.6625,0.16875,0.2
BloodImage_00349.jpg,310.jpg,RBC,100,363,211,479,1,111,116,155,421,0.2421875,0.8770833333333333,0.1734375,0.24166666666666667
BloodImage_00349.jpg,310.jpg,RBC,252,116,363,190,1,111,74,307,153,0.4796875,0.31875,0.1734375,0.15416666666666667
BloodImage_00349.jpg,310.jpg,RBC,234,1,299,115,1,65,114,266,58,0.415625,0.12083333333333333,0.1015625,0.2375
BloodImage_00349.jpg,310.jpg,RBC,512,80,604,170,1,92,90,558,125,0.871875,0.2604166666666667,0.14375,0.1875
BloodImage_00349.jpg,310.jpg,RBC,452,350,547,448,1,95,98,499,399,0.7796875,0.83125,0.1484375,0.20416666666666666
BloodImage_00349.jpg,310.jpg,RBC,1,241,92,346,1,91,105,46,293,0.071875,0.6104166666666667,0.1421875,0.21875
BloodImage_00349.jpg,310.jpg,WBC,202,181,419,392,2,217,211,310,286,0.484375,0.5958333333333333,0.3390625,0.4395833333333333
BloodImage_00350.jpg,311.jpg,WBC,178,285,412,480,2,234,195,295,382,0.4609375,0.7958333333333333,0.365625,0.40625
BloodImage_00351.jpg,312.jpg,RBC,115,108,229,221,1,114,113,172,164,0.26875,0.3416666666666667,0.178125,0.23541666666666666
BloodImage_00351.jpg,312.jpg,RBC,47,25,147,137,1,100,112,97,81,0.1515625,0.16875,0.15625,0.23333333333333334
BloodImage_00351.jpg,312.jpg,RBC,226,72,295,173,1,69,101,260,122,0.40625,0.25416666666666665,0.1078125,0.21041666666666667
BloodImage_00351.jpg,312.jpg,RBC,204,177,316,287,1,112,110,260,232,0.40625,0.48333333333333334,0.175,0.22916666666666666
BloodImage_00351.jpg,312.jpg,RBC,192,282,290,381,1,98,99,241,331,0.3765625,0.6895833333333333,0.153125,0.20625
BloodImage_00351.jpg,312.jpg,RBC,300,247,411,352,1,111,105,355,299,0.5546875,0.6229166666666667,0.1734375,0.21875
BloodImage_00351.jpg,312.jpg,RBC,504,353,633,470,1,129,117,568,411,0.8875,0.85625,0.2015625,0.24375
BloodImage_00351.jpg,312.jpg,RBC,23,230,124,334,1,101,104,73,282,0.1140625,0.5875,0.1578125,0.21666666666666667
BloodImage_00351.jpg,312.jpg,RBC,43,292,166,417,1,123,125,104,354,0.1625,0.7375,0.1921875,0.2604166666666667
BloodImage_00351.jpg,312.jpg,RBC,314,139,420,240,1,106,101,367,189,0.5734375,0.39375,0.165625,0.21041666666666667
BloodImage_00351.jpg,312.jpg,RBC,455,45,588,130,1,133,85,521,87,0.8140625,0.18125,0.2078125,0.17708333333333334
BloodImage_00351.jpg,312.jpg,RBC,309,1,423,86,1,114,85,366,43,0.571875,0.08958333333333333,0.178125,0.17708333333333334
BloodImage_00351.jpg,312.jpg,RBC,223,1,317,81,1,94,80,270,41,0.421875,0.08541666666666667,0.146875,0.16666666666666666
BloodImage_00351.jpg,312.jpg,RBC,371,360,489,480,1,118,120,430,420,0.671875,0.875,0.184375,0.25
BloodImage_00351.jpg,312.jpg,Platelets,147,326,179,355,0,32,29,163,340,0.2546875,0.7083333333333334,0.05,0.06041666666666667
BloodImage_00351.jpg,312.jpg,Platelets,200,397,243,438,0,43,41,221,417,0.3453125,0.86875,0.0671875,0.08541666666666667
BloodImage_00351.jpg,312.jpg,WBC,379,111,619,370,2,240,259,499,240,0.7796875,0.5,0.375,0.5395833333333333
BloodImage_00352.jpg,313.jpg,RBC,316,20,432,111,1,116,91,374,65,0.584375,0.13541666666666666,0.18125,0.18958333333333333
BloodImage_00352.jpg,313.jpg,RBC,34,93,156,194,1,122,101,95,143,0.1484375,0.29791666666666666,0.190625,0.21041666666666667
BloodImage_00352.jpg,313.jpg,RBC,40,203,147,296,1,107,93,93,249,0.1453125,0.51875,0.1671875,0.19375
BloodImage_00352.jpg,313.jpg,RBC,108,186,224,313,1,116,127,166,249,0.259375,0.51875,0.18125,0.26458333333333334
BloodImage_00352.jpg,313.jpg,RBC,234,202,287,336,1,53,134,260,269,0.40625,0.5604166666666667,0.0828125,0.2791666666666667
BloodImage_00352.jpg,313.jpg,RBC,242,269,342,375,1,100,106,292,322,0.45625,0.6708333333333333,0.15625,0.22083333333333333
BloodImage_00352.jpg,313.jpg,RBC,45,349,150,457,1,105,108,97,403,0.1515625,0.8395833333333333,0.1640625,0.225
BloodImage_00352.jpg,313.jpg,RBC,313,122,462,214,1,149,92,387,168,0.6046875,0.35,0.2328125,0.19166666666666668
BloodImage_00352.jpg,313.jpg,RBC,508,136,613,257,1,105,121,560,196,0.875,0.4083333333333333,0.1640625,0.2520833333333333
BloodImage_00352.jpg,313.jpg,RBC,193,405,320,480,1,127,75,256,442,0.4,0.9208333333333333,0.1984375,0.15625
BloodImage_00352.jpg,313.jpg,RBC,147,318,233,432,1,86,114,190,375,0.296875,0.78125,0.134375,0.2375
BloodImage_00352.jpg,313.jpg,RBC,119,13,235,118,1,116,105,177,65,0.2765625,0.13541666666666666,0.18125,0.21875
BloodImage_00352.jpg,313.jpg,WBC,294,181,632,432,2,338,251,463,306,0.7234375,0.6375,0.528125,0.5229166666666667
BloodImage_00353.jpg,314.jpg,RBC,52,332,161,452,1,109,120,106,392,0.165625,0.8166666666666667,0.1703125,0.25
BloodImage_00353.jpg,314.jpg,RBC,176,315,319,416,1,143,101,247,365,0.3859375,0.7604166666666666,0.2234375,0.21041666666666667
BloodImage_00353.jpg,314.jpg,RBC,34,48,152,156,1,118,108,93,102,0.1453125,0.2125,0.184375,0.225
BloodImage_00353.jpg,314.jpg,RBC,320,42,438,150,1,118,108,379,96,0.5921875,0.2,0.184375,0.225
BloodImage_00353.jpg,314.jpg,RBC,204,83,323,203,1,119,120,263,143,0.4109375,0.29791666666666666,0.1859375,0.25
BloodImage_00353.jpg,314.jpg,RBC,536,196,635,295,1,99,99,585,245,0.9140625,0.5104166666666666,0.1546875,0.20625
BloodImage_00353.jpg,314.jpg,RBC,83,174,186,278,1,103,104,134,226,0.209375,0.4708333333333333,0.1609375,0.21666666666666667
BloodImage_00353.jpg,314.jpg,RBC,121,144,205,229,1,84,85,163,186,0.2546875,0.3875,0.13125,0.17708333333333334
BloodImage_00353.jpg,314.jpg,RBC,189,211,303,301,1,114,90,246,256,0.384375,0.5333333333333333,0.178125,0.1875
BloodImage_00353.jpg,314.jpg,RBC,147,14,236,106,1,89,92,191,60,0.2984375,0.125,0.1390625,0.19166666666666668
BloodImage_00353.jpg,314.jpg,RBC,501,73,615,170,1,114,97,558,121,0.871875,0.2520833333333333,0.178125,0.20208333333333334
BloodImage_00353.jpg,314.jpg,RBC,1,141,80,259,1,79,118,40,200,0.0625,0.4166666666666667,0.1234375,0.24583333333333332
BloodImage_00353.jpg,314.jpg,RBC,485,176,546,240,1,61,64,515,208,0.8046875,0.43333333333333335,0.0953125,0.13333333333333333
BloodImage_00353.jpg,314.jpg,WBC,262,191,518,436,2,256,245,390,313,0.609375,0.6520833333333333,0.4,0.5104166666666666
BloodImage_00354.jpg,315.jpg,RBC,369,40,470,152,1,101,112,419,96,0.6546875,0.2,0.1578125,0.23333333333333334
BloodImage_00354.jpg,315.jpg,RBC,473,156,574,268,1,101,112,523,212,0.8171875,0.44166666666666665,0.1578125,0.23333333333333334
BloodImage_00354.jpg,315.jpg,RBC,446,278,569,386,1,123,108,507,332,0.7921875,0.6916666666666667,0.1921875,0.225
BloodImage_00354.jpg,315.jpg,RBC,534,364,640,462,1,106,98,587,413,0.9171875,0.8604166666666667,0.165625,0.20416666666666666
BloodImage_00354.jpg,315.jpg,RBC,405,371,511,480,1,106,109,458,425,0.715625,0.8854166666666666,0.165625,0.22708333333333333
BloodImage_00354.jpg,315.jpg,RBC,559,97,640,204,1,81,107,599,150,0.9359375,0.3125,0.1265625,0.22291666666666668
BloodImage_00354.jpg,315.jpg,RBC,469,1,562,89,1,93,88,515,45,0.8046875,0.09375,0.1453125,0.18333333333333332
BloodImage_00354.jpg,315.jpg,RBC,277,343,352,453,1,75,110,314,398,0.490625,0.8291666666666667,0.1171875,0.22916666666666666
BloodImage_00354.jpg,315.jpg,RBC,209,352,329,443,1,120,91,269,397,0.4203125,0.8270833333333333,0.1875,0.18958333333333333
BloodImage_00354.jpg,315.jpg,RBC,96,345,201,455,1,105,110,148,400,0.23125,0.8333333333333334,0.1640625,0.22916666666666666
BloodImage_00354.jpg,315.jpg,RBC,374,143,465,225,1,91,82,419,184,0.6546875,0.38333333333333336,0.1421875,0.17083333333333334
BloodImage_00354.jpg,315.jpg,RBC,183,27,283,120,1,100,93,233,73,0.3640625,0.15208333333333332,0.15625,0.19375
BloodImage_00354.jpg,315.jpg,RBC,41,201,141,294,1,100,93,91,247,0.1421875,0.5145833333333333,0.15625,0.19375
BloodImage_00354.jpg,315.jpg,RBC,106,10,203,119,1,97,109,154,64,0.240625,0.13333333333333333,0.1515625,0.22708333333333333
BloodImage_00354.jpg,315.jpg,RBC,26,94,139,209,1,113,115,82,151,0.128125,0.3145833333333333,0.1765625,0.23958333333333334
BloodImage_00354.jpg,315.jpg,WBC,117,138,361,377,2,244,239,239,257,0.3734375,0.5354166666666667,0.38125,0.4979166666666667
BloodImage_00355.jpg,316.jpg,RBC,27,135,146,245,1,119,110,86,190,0.134375,0.3958333333333333,0.1859375,0.22916666666666666
BloodImage_00355.jpg,316.jpg,RBC,192,228,307,368,1,115,140,249,298,0.3890625,0.6208333333333333,0.1796875,0.2916666666666667
BloodImage_00355.jpg,316.jpg,RBC,67,24,186,134,1,119,110,126,79,0.196875,0.16458333333333333,0.1859375,0.22916666666666666
BloodImage_00355.jpg,316.jpg,RBC,282,168,381,281,1,99,113,331,224,0.5171875,0.4666666666666667,0.1546875,0.23541666666666666
BloodImage_00355.jpg,316.jpg,RBC,271,338,372,448,1,101,110,321,393,0.5015625,0.81875,0.1578125,0.22916666666666666
BloodImage_00355.jpg,316.jpg,RBC,67,246,178,345,1,111,99,122,295,0.190625,0.6145833333333334,0.1734375,0.20625
BloodImage_00355.jpg,316.jpg,RBC,63,307,174,406,1,111,99,118,356,0.184375,0.7416666666666667,0.1734375,0.20625
BloodImage_00355.jpg,316.jpg,RBC,336,1,445,81,1,109,80,390,41,0.609375,0.08541666666666667,0.1703125,0.16666666666666666
BloodImage_00355.jpg,316.jpg,RBC,493,105,591,199,1,98,94,542,152,0.846875,0.31666666666666665,0.153125,0.19583333333333333
BloodImage_00355.jpg,316.jpg,RBC,433,50,507,139,1,74,89,470,94,0.734375,0.19583333333333333,0.115625,0.18541666666666667
BloodImage_00355.jpg,316.jpg,RBC,476,1,555,95,1,79,94,515,48,0.8046875,0.1,0.1234375,0.19583333333333333
BloodImage_00355.jpg,316.jpg,RBC,555,19,640,123,1,85,104,597,71,0.9328125,0.14791666666666667,0.1328125,0.21666666666666667
BloodImage_00355.jpg,316.jpg,RBC,280,68,383,159,1,103,91,331,113,0.5171875,0.23541666666666666,0.1609375,0.18958333333333333
BloodImage_00355.jpg,316.jpg,RBC,370,143,490,228,1,120,85,430,185,0.671875,0.3854166666666667,0.1875,0.17708333333333334
BloodImage_00355.jpg,316.jpg,Platelets,229,411,278,452,0,49,41,253,431,0.3953125,0.8979166666666667,0.0765625,0.08541666666666667
BloodImage_00355.jpg,316.jpg,Platelets,140,210,183,251,0,43,41,161,230,0.2515625,0.4791666666666667,0.0671875,0.08541666666666667
BloodImage_00355.jpg,316.jpg,Platelets,262,6,300,48,0,38,42,281,27,0.4390625,0.05625,0.059375,0.0875
BloodImage_00355.jpg,316.jpg,Platelets,419,119,456,155,0,37,36,437,137,0.6828125,0.28541666666666665,0.0578125,0.075
BloodImage_00355.jpg,316.jpg,WBC,330,211,566,436,2,236,225,448,323,0.7,0.6729166666666667,0.36875,0.46875
BloodImage_00356.jpg,317.jpg,RBC,279,310,396,422,1,117,112,337,366,0.5265625,0.7625,0.1828125,0.23333333333333334
BloodImage_00356.jpg,317.jpg,RBC,373,191,491,275,1,118,84,432,233,0.675,0.48541666666666666,0.184375,0.175
BloodImage_00356.jpg,317.jpg,RBC,447,355,554,448,1,107,93,500,401,0.78125,0.8354166666666667,0.1671875,0.19375
BloodImage_00356.jpg,317.jpg,RBC,504,156,609,265,1,105,109,556,210,0.86875,0.4375,0.1640625,0.22708333333333333
BloodImage_00356.jpg,317.jpg,RBC,499,303,600,395,1,101,92,549,349,0.8578125,0.7270833333333333,0.1578125,0.19166666666666668
BloodImage_00356.jpg,317.jpg,RBC,419,413,512,480,1,93,67,465,446,0.7265625,0.9291666666666667,0.1453125,0.13958333333333334
BloodImage_00356.jpg,317.jpg,RBC,59,353,142,450,1,83,97,100,401,0.15625,0.8354166666666667,0.1296875,0.20208333333333334
BloodImage_00356.jpg,317.jpg,RBC,203,118,302,213,1,99,95,252,165,0.39375,0.34375,0.1546875,0.19791666666666666
BloodImage_00356.jpg,317.jpg,RBC,487,7,586,102,1,99,95,536,54,0.8375,0.1125,0.1546875,0.19791666666666666
BloodImage_00356.jpg,317.jpg,RBC,361,94,479,187,1,118,93,420,140,0.65625,0.2916666666666667,0.184375,0.19375
BloodImage_00356.jpg,317.jpg,RBC,29,12,128,107,1,99,95,78,59,0.121875,0.12291666666666666,0.1546875,0.19791666666666666
BloodImage_00356.jpg,317.jpg,RBC,96,102,200,192,1,104,90,148,147,0.23125,0.30625,0.1625,0.1875
BloodImage_00356.jpg,317.jpg,RBC,228,4,331,103,1,103,99,279,53,0.4359375,0.11041666666666666,0.1609375,0.20625
BloodImage_00356.jpg,317.jpg,RBC,325,1,433,79,1,108,78,379,40,0.5921875,0.08333333333333333,0.16875,0.1625
BloodImage_00356.jpg,317.jpg,RBC,126,1,221,99,1,95,98,173,50,0.2703125,0.10416666666666667,0.1484375,0.20416666666666666
BloodImage_00356.jpg,317.jpg,RBC,1,196,106,285,1,105,89,53,240,0.0828125,0.5,0.1640625,0.18541666666666667
BloodImage_00356.jpg,317.jpg,WBC,117,230,295,416,2,178,186,206,323,0.321875,0.6729166666666667,0.278125,0.3875
BloodImage_00357.jpg,318.jpg,RBC,5,249,90,354,1,85,105,47,301,0.0734375,0.6270833333333333,0.1328125,0.21875
BloodImage_00357.jpg,318.jpg,RBC,210,8,323,118,1,113,110,266,63,0.415625,0.13125,0.1765625,0.22916666666666666
BloodImage_00357.jpg,318.jpg,RBC,158,283,256,394,1,98,111,207,338,0.3234375,0.7041666666666667,0.153125,0.23125
BloodImage_00357.jpg,318.jpg,RBC,83,399,166,480,1,83,81,124,439,0.19375,0.9145833333333333,0.1296875,0.16875
BloodImage_00357.jpg,318.jpg,RBC,534,13,635,116,1,101,103,584,64,0.9125,0.13333333333333333,0.1578125,0.21458333333333332
BloodImage_00357.jpg,318.jpg,RBC,409,85,499,173,1,90,88,454,129,0.709375,0.26875,0.140625,0.18333333333333332
BloodImage_00357.jpg,318.jpg,RBC,247,225,360,325,1,113,100,303,275,0.4734375,0.5729166666666666,0.1765625,0.20833333333333334
BloodImage_00357.jpg,318.jpg,RBC,268,293,381,393,1,113,100,324,343,0.50625,0.7145833333333333,0.1765625,0.20833333333333334
BloodImage_00357.jpg,318.jpg,RBC,84,179,192,293,1,108,114,138,236,0.215625,0.49166666666666664,0.16875,0.2375
BloodImage_00357.jpg,318.jpg,RBC,155,157,263,271,1,108,114,209,214,0.3265625,0.44583333333333336,0.16875,0.2375
BloodImage_00357.jpg,318.jpg,RBC,150,1,256,111,1,106,110,203,56,0.3171875,0.11666666666666667,0.165625,0.22916666666666666
BloodImage_00357.jpg,318.jpg,RBC,333,361,433,431,1,100,70,383,396,0.5984375,0.825,0.15625,0.14583333333333334
BloodImage_00357.jpg,318.jpg,RBC,1,112,90,200,1,89,88,45,156,0.0703125,0.325,0.1390625,0.18333333333333332
BloodImage_00357.jpg,318.jpg,WBC,383,205,625,434,2,242,229,504,319,0.7875,0.6645833333333333,0.378125,0.47708333333333336
BloodImage_00359.jpg,319.jpg,RBC,225,233,324,324,1,99,91,274,278,0.428125,0.5791666666666667,0.1546875,0.18958333333333333
BloodImage_00359.jpg,319.jpg,RBC,483,222,562,302,1,79,80,522,262,0.815625,0.5458333333333333,0.1234375,0.16666666666666666
BloodImage_00359.jpg,319.jpg,RBC,358,181,467,287,1,109,106,412,234,0.64375,0.4875,0.1703125,0.22083333333333333
BloodImage_00359.jpg,319.jpg,RBC,335,369,444,475,1,109,106,389,422,0.6078125,0.8791666666666667,0.1703125,0.22083333333333333
BloodImage_00359.jpg,319.jpg,RBC,221,352,330,458,1,109,106,275,405,0.4296875,0.84375,0.1703125,0.22083333333333333
BloodImage_00359.jpg,319.jpg,RBC,378,279,488,378,1,110,99,433,328,0.6765625,0.6833333333333333,0.171875,0.20625
BloodImage_00359.jpg,319.jpg,RBC,423,32,511,125,1,88,93,467,78,0.7296875,0.1625,0.1375,0.19375
BloodImage_00359.jpg,319.jpg,RBC,515,289,629,384,1,114,95,572,336,0.89375,0.7,0.178125,0.19791666666666666
BloodImage_00359.jpg,319.jpg,RBC,22,73,129,171,1,107,98,75,122,0.1171875,0.25416666666666665,0.1671875,0.20416666666666666
BloodImage_00359.jpg,319.jpg,RBC,125,75,224,166,1,99,91,174,120,0.271875,0.25,0.1546875,0.18958333333333333
BloodImage_00359.jpg,319.jpg,RBC,224,18,327,124,1,103,106,275,71,0.4296875,0.14791666666666667,0.1609375,0.22083333333333333
BloodImage_00359.jpg,319.jpg,RBC,326,73,427,190,1,101,117,376,131,0.5875,0.27291666666666664,0.1578125,0.24375
BloodImage_00359.jpg,319.jpg,RBC,554,40,640,165,1,86,125,597,102,0.9328125,0.2125,0.134375,0.2604166666666667
BloodImage_00359.jpg,319.jpg,RBC,143,1,242,65,1,99,64,192,33,0.3,0.06875,0.1546875,0.13333333333333333
BloodImage_00359.jpg,319.jpg,WBC,1,201,219,422,2,218,221,110,311,0.171875,0.6479166666666667,0.340625,0.46041666666666664
BloodImage_00360.jpg,320.jpg,RBC,42,242,140,361,1,98,119,91,301,0.1421875,0.6270833333333333,0.153125,0.24791666666666667
BloodImage_00360.jpg,320.jpg,RBC,54,56,152,175,1,98,119,103,115,0.1609375,0.23958333333333334,0.153125,0.24791666666666667
BloodImage_00360.jpg,320.jpg,RBC,146,265,244,384,1,98,119,195,324,0.3046875,0.675,0.153125,0.24791666666666667
BloodImage_00360.jpg,320.jpg,RBC,449,311,560,428,1,111,117,504,369,0.7875,0.76875,0.1734375,0.24375
BloodImage_00360.jpg,320.jpg,RBC,200,142,304,253,1,104,111,252,197,0.39375,0.41041666666666665,0.1625,0.23125
BloodImage_00360.jpg,320.jpg,RBC,205,59,313,147,1,108,88,259,103,0.4046875,0.21458333333333332,0.16875,0.18333333333333332
BloodImage_00360.jpg,320.jpg,RBC,529,238,628,331,1,99,93,578,284,0.903125,0.5916666666666667,0.1546875,0.19375
BloodImage_00360.jpg,320.jpg,RBC,220,377,334,479,1,114,102,277,428,0.4328125,0.8916666666666667,0.178125,0.2125
BloodImage_00360.jpg,320.jpg,RBC,133,394,232,480,1,99,86,182,437,0.284375,0.9104166666666667,0.1546875,0.17916666666666667
BloodImage_00360.jpg,320.jpg,RBC,329,129,456,224,1,127,95,392,176,0.6125,0.36666666666666664,0.1984375,0.19791666666666666
BloodImage_00360.jpg,320.jpg,RBC,291,1,400,84,1,109,83,345,42,0.5390625,0.0875,0.1703125,0.17291666666666666
BloodImage_00360.jpg,320.jpg,WBC,246,211,477,415,2,231,204,361,313,0.5640625,0.6520833333333333,0.3609375,0.425
BloodImage_00360.jpg,320.jpg,Platelets,564,333,596,372,0,32,39,580,352,0.90625,0.7333333333333333,0.05,0.08125
BloodImage_00361.jpg,321.jpg,RBC,457,164,553,251,1,96,87,505,207,0.7890625,0.43125,0.15,0.18125
BloodImage_00361.jpg,321.jpg,RBC,501,261,586,351,1,85,90,543,306,0.8484375,0.6375,0.1328125,0.1875
BloodImage_00361.jpg,321.jpg,RBC,570,303,640,406,1,70,103,605,354,0.9453125,0.7375,0.109375,0.21458333333333332
BloodImage_00361.jpg,321.jpg,RBC,472,353,579,445,1,107,92,525,399,0.8203125,0.83125,0.1671875,0.19166666666666668
BloodImage_00361.jpg,321.jpg,RBC,44,310,136,403,1,92,93,90,356,0.140625,0.7416666666666667,0.14375,0.19375
BloodImage_00361.jpg,321.jpg,RBC,25,394,138,479,1,113,85,81,436,0.1265625,0.9083333333333333,0.1765625,0.17708333333333334
BloodImage_00361.jpg,321.jpg,RBC,121,274,244,394,1,123,120,182,334,0.284375,0.6958333333333333,0.1921875,0.25
BloodImage_00361.jpg,321.jpg,RBC,162,140,259,249,1,97,109,210,194,0.328125,0.4041666666666667,0.1515625,0.22708333333333333
BloodImage_00361.jpg,321.jpg,RBC,19,1,98,87,1,79,86,58,44,0.090625,0.09166666666666666,0.1234375,0.17916666666666667
BloodImage_00361.jpg,321.jpg,RBC,153,47,254,137,1,101,90,203,92,0.3171875,0.19166666666666668,0.1578125,0.1875
BloodImage_00361.jpg,321.jpg,RBC,232,415,318,480,1,86,65,275,447,0.4296875,0.93125,0.134375,0.13541666666666666
BloodImage_00361.jpg,321.jpg,RBC,95,38,192,158,1,97,120,143,98,0.2234375,0.20416666666666666,0.1515625,0.25
BloodImage_00361.jpg,321.jpg,RBC,574,208,640,300,1,66,92,607,254,0.9484375,0.5291666666666667,0.103125,0.19166666666666668
BloodImage_00361.jpg,321.jpg,RBC,225,223,321,310,1,96,87,273,266,0.4265625,0.5541666666666667,0.15,0.18125
BloodImage_00361.jpg,321.jpg,WBC,215,40,458,268,2,243,228,336,154,0.525,0.32083333333333336,0.3796875,0.475
BloodImage_00362.jpg,322.jpg,RBC,212,274,320,379,1,108,105,266,326,0.415625,0.6791666666666667,0.16875,0.21875
BloodImage_00362.jpg,322.jpg,RBC,120,244,216,347,1,96,103,168,295,0.2625,0.6145833333333334,0.15,0.21458333333333332
BloodImage_00362.jpg,322.jpg,RBC,242,157,338,260,1,96,103,290,208,0.453125,0.43333333333333335,0.15,0.21458333333333332
BloodImage_00362.jpg,322.jpg,RBC,85,133,196,241,1,111,108,140,187,0.21875,0.38958333333333334,0.1734375,0.225
BloodImage_00362.jpg,322.jpg,RBC,509,97,620,205,1,111,108,564,151,0.88125,0.3145833333333333,0.1734375,0.225
BloodImage_00362.jpg,322.jpg,RBC,139,3,250,111,1,111,108,194,57,0.303125,0.11875,0.1734375,0.225
BloodImage_00362.jpg,322.jpg,RBC,392,101,520,214,1,128,113,456,157,0.7125,0.32708333333333334,0.2,0.23541666666666666
BloodImage_00362.jpg,322.jpg,RBC,319,136,480,224,1,161,88,399,180,0.6234375,0.375,0.2515625,0.18333333333333332
BloodImage_00362.jpg,322.jpg,RBC,360,248,502,348,1,142,100,431,298,0.6734375,0.6208333333333333,0.221875,0.20833333333333334
BloodImage_00362.jpg,322.jpg,RBC,460,286,573,392,1,113,106,516,339,0.80625,0.70625,0.1765625,0.22083333333333333
BloodImage_00362.jpg,322.jpg,RBC,482,398,583,480,1,101,82,532,439,0.83125,0.9145833333333333,0.1578125,0.17083333333333334
BloodImage_00362.jpg,322.jpg,WBC,27,340,217,480,2,190,140,122,410,0.190625,0.8541666666666666,0.296875,0.2916666666666667
BloodImage_00364.jpg,323.jpg,RBC,186,102,270,197,1,84,95,228,149,0.35625,0.3104166666666667,0.13125,0.19791666666666666
BloodImage_00364.jpg,323.jpg,RBC,520,118,604,213,1,84,95,562,165,0.878125,0.34375,0.13125,0.19791666666666666
BloodImage_00364.jpg,323.jpg,RBC,556,301,640,396,1,84,95,598,348,0.934375,0.725,0.13125,0.19791666666666666
BloodImage_00364.jpg,323.jpg,RBC,146,200,259,304,1,113,104,202,252,0.315625,0.525,0.1765625,0.21666666666666667
BloodImage_00364.jpg,323.jpg,RBC,253,174,354,281,1,101,107,303,227,0.4734375,0.47291666666666665,0.1578125,0.22291666666666668
BloodImage_00364.jpg,323.jpg,RBC,189,292,281,400,1,92,108,235,346,0.3671875,0.7208333333333333,0.14375,0.225
BloodImage_00364.jpg,323.jpg,RBC,418,246,522,353,1,104,107,470,299,0.734375,0.6229166666666667,0.1625,0.22291666666666668
BloodImage_00364.jpg,323.jpg,RBC,37,236,138,334,1,101,98,87,285,0.1359375,0.59375,0.1578125,0.20416666666666666
BloodImage_00364.jpg,323.jpg,RBC,77,1,201,90,1,124,89,139,45,0.2171875,0.09375,0.19375,0.18541666666666667
BloodImage_00364.jpg,323.jpg,RBC,336,408,457,480,1,121,72,396,444,0.61875,0.925,0.1890625,0.15
BloodImage_00364.jpg,323.jpg,RBC,348,151,449,258,1,101,107,398,204,0.621875,0.425,0.1578125,0.22291666666666668
BloodImage_00364.jpg,323.jpg,RBC,538,214,640,290,1,102,76,589,252,0.9203125,0.525,0.159375,0.15833333333333333
BloodImage_00364.jpg,323.jpg,RBC,51,100,155,217,1,104,117,103,158,0.1609375,0.32916666666666666,0.1625,0.24375
BloodImage_00364.jpg,323.jpg,RBC,74,325,176,434,1,102,109,125,379,0.1953125,0.7895833333333333,0.159375,0.22708333333333333
BloodImage_00364.jpg,323.jpg,Platelets,177,398,224,443,0,47,45,200,420,0.3125,0.875,0.0734375,0.09375
BloodImage_00364.jpg,323.jpg,WBC,325,1,545,162,2,220,161,435,81,0.6796875,0.16875,0.34375,0.33541666666666664
BloodImage_00365.jpg,324.jpg,RBC,200,336,303,433,1,103,97,251,384,0.3921875,0.8,0.1609375,0.20208333333333334
BloodImage_00365.jpg,324.jpg,RBC,1,370,86,468,1,85,98,43,419,0.0671875,0.8729166666666667,0.1328125,0.20416666666666666
BloodImage_00365.jpg,324.jpg,RBC,271,113,421,193,1,150,80,346,153,0.540625,0.31875,0.234375,0.16666666666666666
BloodImage_00365.jpg,324.jpg,RBC,167,249,292,329,1,125,80,229,289,0.3578125,0.6020833333333333,0.1953125,0.16666666666666666
BloodImage_00365.jpg,324.jpg,RBC,238,24,358,113,1,120,89,298,68,0.465625,0.14166666666666666,0.1875,0.18541666666666667
BloodImage_00365.jpg,324.jpg,RBC,65,7,169,109,1,104,102,117,58,0.1828125,0.12083333333333333,0.1625,0.2125
BloodImage_00365.jpg,324.jpg,RBC,304,251,410,357,1,106,106,357,304,0.5578125,0.6333333333333333,0.165625,0.22083333333333333
BloodImage_00365.jpg,324.jpg,RBC,395,220,511,320,1,116,100,453,270,0.7078125,0.5625,0.18125,0.20833333333333334
BloodImage_00365.jpg,324.jpg,RBC,417,304,538,407,1,121,103,477,355,0.7453125,0.7395833333333334,0.1890625,0.21458333333333332
BloodImage_00365.jpg,324.jpg,RBC,522,103,633,214,1,111,111,577,158,0.9015625,0.32916666666666666,0.1734375,0.23125
BloodImage_00365.jpg,324.jpg,RBC,525,185,616,296,1,91,111,570,240,0.890625,0.5,0.1421875,0.23125
BloodImage_00365.jpg,324.jpg,RBC,329,409,429,480,1,100,71,379,444,0.5921875,0.925,0.15625,0.14791666666666667
BloodImage_00365.jpg,324.jpg,Platelets,513,405,559,446,0,46,41,536,425,0.8375,0.8854166666666666,0.071875,0.08541666666666667
BloodImage_00365.jpg,324.jpg,Platelets,611,299,640,329,0,29,30,625,314,0.9765625,0.6541666666666667,0.0453125,0.0625
BloodImage_00365.jpg,324.jpg,WBC,1,92,168,289,2,167,197,84,190,0.13125,0.3958333333333333,0.2609375,0.41041666666666665
BloodImage_00365.jpg,324.jpg,Platelets,4,13,40,42,0,36,29,22,27,0.034375,0.05625,0.05625,0.06041666666666667
BloodImage_00366.jpg,325.jpg,RBC,343,130,454,231,1,111,101,398,180,0.621875,0.375,0.1734375,0.21041666666666667
BloodImage_00366.jpg,325.jpg,RBC,329,262,440,363,1,111,101,384,312,0.6,0.65,0.1734375,0.21041666666666667
BloodImage_00366.jpg,325.jpg,RBC,365,354,476,455,1,111,101,420,404,0.65625,0.8416666666666667,0.1734375,0.21041666666666667
BloodImage_00366.jpg,325.jpg,RBC,143,75,254,176,1,111,101,198,125,0.309375,0.2604166666666667,0.1734375,0.21041666666666667
BloodImage_00366.jpg,325.jpg,RBC,72,18,153,99,1,81,81,112,58,0.175,0.12083333333333333,0.1265625,0.16875
BloodImage_00366.jpg,325.jpg,RBC,142,250,243,349,1,101,99,192,299,0.3,0.6229166666666667,0.1578125,0.20625
BloodImage_00366.jpg,325.jpg,RBC,67,271,168,370,1,101,99,117,320,0.1828125,0.6666666666666666,0.1578125,0.20625
BloodImage_00366.jpg,325.jpg,RBC,130,348,235,440,1,105,92,182,394,0.284375,0.8208333333333333,0.1640625,0.19166666666666668
BloodImage_00366.jpg,325.jpg,RBC,469,81,574,173,1,105,92,521,127,0.8140625,0.26458333333333334,0.1640625,0.19166666666666668
BloodImage_00366.jpg,325.jpg,RBC,444,254,566,355,1,122,101,505,304,0.7890625,0.6333333333333333,0.190625,0.21041666666666667
BloodImage_00366.jpg,325.jpg,RBC,535,162,640,284,1,105,122,587,223,0.9171875,0.46458333333333335,0.1640625,0.25416666666666665
BloodImage_00366.jpg,325.jpg,RBC,348,7,453,99,1,105,92,400,53,0.625,0.11041666666666666,0.1640625,0.19166666666666668
BloodImage_00366.jpg,325.jpg,RBC,388,18,493,110,1,105,92,440,64,0.6875,0.13333333333333333,0.1640625,0.19166666666666668
BloodImage_00366.jpg,325.jpg,RBC,529,327,634,419,1,105,92,581,373,0.9078125,0.7770833333333333,0.1640625,0.19166666666666668
BloodImage_00366.jpg,325.jpg,WBC,1,81,147,294,2,146,213,74,187,0.115625,0.38958333333333334,0.228125,0.44375
BloodImage_00366.jpg,325.jpg,Platelets,174,203,212,250,0,38,47,193,226,0.3015625,0.4708333333333333,0.059375,0.09791666666666667
BloodImage_00367.jpg,326.jpg,RBC,285,367,386,480,1,101,113,335,423,0.5234375,0.88125,0.1578125,0.23541666666666666
BloodImage_00367.jpg,326.jpg,RBC,386,360,492,453,1,106,93,439,406,0.6859375,0.8458333333333333,0.165625,0.19375
BloodImage_00367.jpg,326.jpg,RBC,293,67,402,167,1,109,100,347,117,0.5421875,0.24375,0.1703125,0.20833333333333334
BloodImage_00367.jpg,326.jpg,RBC,392,17,507,137,1,115,120,449,77,0.7015625,0.16041666666666668,0.1796875,0.25
BloodImage_00367.jpg,326.jpg,RBC,296,268,410,362,1,114,94,353,315,0.5515625,0.65625,0.178125,0.19583333333333333
BloodImage_00367.jpg,326.jpg,RBC,203,1,321,89,1,118,88,262,45,0.409375,0.09375,0.184375,0.18333333333333332
BloodImage_00367.jpg,326.jpg,RBC,345,178,429,283,1,84,105,387,230,0.6046875,0.4791666666666667,0.13125,0.21875
BloodImage_00367.jpg,326.jpg,RBC,535,1,638,106,1,103,105,586,53,0.915625,0.11041666666666666,0.1609375,0.21875
BloodImage_00367.jpg,326.jpg,RBC,415,146,519,253,1,104,107,467,199,0.7296875,0.41458333333333336,0.1625,0.22291666666666668
BloodImage_00367.jpg,326.jpg,RBC,436,258,539,355,1,103,97,487,306,0.7609375,0.6375,0.1609375,0.20208333333333334
BloodImage_00367.jpg,326.jpg,RBC,120,52,222,159,1,102,107,171,105,0.2671875,0.21875,0.159375,0.22291666666666668
BloodImage_00367.jpg,326.jpg,RBC,518,134,613,235,1,95,101,565,184,0.8828125,0.38333333333333336,0.1484375,0.21041666666666667
BloodImage_00367.jpg,326.jpg,RBC,508,355,623,440,1,115,85,565,397,0.8828125,0.8270833333333333,0.1796875,0.17708333333333334
BloodImage_00367.jpg,326.jpg,RBC,1,96,85,205,1,84,109,43,150,0.0671875,0.3125,0.13125,0.22708333333333333
BloodImage_00367.jpg,326.jpg,WBC,23,227,223,440,2,200,213,123,333,0.1921875,0.69375,0.3125,0.44375
BloodImage_00367.jpg,326.jpg,Platelets,322,209,357,251,0,35,42,339,230,0.5296875,0.4791666666666667,0.0546875,0.0875
BloodImage_00368.jpg,327.jpg,RBC,260,359,397,454,1,137,95,328,406,0.5125,0.8458333333333333,0.2140625,0.19791666666666666
BloodImage_00368.jpg,327.jpg,RBC,303,288,396,379,1,93,91,349,333,0.5453125,0.69375,0.1453125,0.18958333333333333
BloodImage_00368.jpg,327.jpg,RBC,440,344,558,442,1,118,98,499,393,0.7796875,0.81875,0.184375,0.20416666666666666
BloodImage_00368.jpg,327.jpg,RBC,364,54,467,152,1,103,98,415,103,0.6484375,0.21458333333333332,0.1609375,0.20416666666666666
BloodImage_00368.jpg,327.jpg,RBC,231,87,337,177,1,106,90,284,132,0.44375,0.275,0.165625,0.1875
BloodImage_00368.jpg,327.jpg,RBC,262,164,357,250,1,95,86,309,207,0.4828125,0.43125,0.1484375,0.17916666666666667
BloodImage_00368.jpg,327.jpg,RBC,128,27,256,140,1,128,113,192,83,0.3,0.17291666666666666,0.2,0.23541666666666666
BloodImage_00368.jpg,327.jpg,RBC,438,1,531,95,1,93,94,484,48,0.75625,0.1,0.1453125,0.19583333333333333
BloodImage_00368.jpg,327.jpg,RBC,483,1,598,100,1,115,99,540,50,0.84375,0.10416666666666667,0.1796875,0.20625
BloodImage_00368.jpg,327.jpg,RBC,366,217,512,334,1,146,117,439,275,0.6859375,0.5729166666666666,0.228125,0.24375
BloodImage_00368.jpg,327.jpg,RBC,370,144,482,237,1,112,93,426,190,0.665625,0.3958333333333333,0.175,0.19375
BloodImage_00368.jpg,327.jpg,RBC,122,325,237,451,1,115,126,179,388,0.2796875,0.8083333333333333,0.1796875,0.2625
BloodImage_00368.jpg,327.jpg,RBC,507,176,611,282,1,104,106,559,229,0.8734375,0.47708333333333336,0.1625,0.22083333333333333
BloodImage_00368.jpg,327.jpg,WBC,1,223,132,434,2,131,211,66,328,0.103125,0.6833333333333333,0.2046875,0.4395833333333333
BloodImage_00369.jpg,328.jpg,RBC,275,289,370,408,1,95,119,322,348,0.503125,0.725,0.1484375,0.24791666666666667
BloodImage_00369.jpg,328.jpg,RBC,392,304,488,382,1,96,78,440,343,0.6875,0.7145833333333333,0.15,0.1625
BloodImage_00369.jpg,328.jpg,RBC,11,251,125,352,1,114,101,68,301,0.10625,0.6270833333333333,0.178125,0.21041666666666667
BloodImage_00369.jpg,328.jpg,RBC,128,307,224,421,1,96,114,176,364,0.275,0.7583333333333333,0.15,0.2375
BloodImage_00369.jpg,328.jpg,RBC,7,333,119,442,1,112,109,63,387,0.0984375,0.80625,0.175,0.22708333333333333
BloodImage_00369.jpg,328.jpg,RBC,159,137,270,243,1,111,106,214,190,0.334375,0.3958333333333333,0.1734375,0.22083333333333333
BloodImage_00369.jpg,328.jpg,RBC,502,242,620,344,1,118,102,561,293,0.8765625,0.6104166666666667,0.184375,0.2125
BloodImage_00369.jpg,328.jpg,RBC,401,378,520,470,1,119,92,460,424,0.71875,0.8833333333333333,0.1859375,0.19166666666666668
BloodImage_00369.jpg,328.jpg,RBC,242,113,348,234,1,106,121,295,173,0.4609375,0.36041666666666666,0.165625,0.2520833333333333
BloodImage_00369.jpg,328.jpg,RBC,1,80,98,178,1,97,98,49,129,0.0765625,0.26875,0.1515625,0.20416666666666666
BloodImage_00369.jpg,328.jpg,RBC,1,169,111,273,1,110,104,56,221,0.0875,0.46041666666666664,0.171875,0.21666666666666667
BloodImage_00369.jpg,328.jpg,RBC,111,49,228,147,1,117,98,169,98,0.2640625,0.20416666666666666,0.1828125,0.20416666666666666
BloodImage_00369.jpg,328.jpg,RBC,388,43,499,117,1,111,74,443,80,0.6921875,0.16666666666666666,0.1734375,0.15416666666666667
BloodImage_00369.jpg,328.jpg,RBC,496,29,599,150,1,103,121,547,89,0.8546875,0.18541666666666667,0.1609375,0.2520833333333333
BloodImage_00369.jpg,328.jpg,RBC,237,412,342,480,1,105,68,289,446,0.4515625,0.9291666666666667,0.1640625,0.14166666666666666
BloodImage_00369.jpg,328.jpg,RBC,300,1,397,85,1,97,84,348,43,0.54375,0.08958333333333333,0.1515625,0.175
BloodImage_00369.jpg,328.jpg,RBC,69,1,163,85,1,94,84,116,43,0.18125,0.08958333333333333,0.146875,0.175
BloodImage_00369.jpg,328.jpg,WBC,324,107,522,303,2,198,196,423,205,0.6609375,0.4270833333333333,0.309375,0.4083333333333333
BloodImage_00369.jpg,328.jpg,Platelets,349,396,394,449,0,45,53,371,422,0.5796875,0.8791666666666667,0.0703125,0.11041666666666666
BloodImage_00369.jpg,328.jpg,Platelets,589,129,640,194,0,51,65,614,161,0.959375,0.33541666666666664,0.0796875,0.13541666666666666
BloodImage_00370.jpg,329.jpg,RBC,18,68,133,164,1,115,96,75,116,0.1171875,0.24166666666666667,0.1796875,0.2
BloodImage_00370.jpg,329.jpg,RBC,20,168,129,259,1,109,91,74,213,0.115625,0.44375,0.1703125,0.18958333333333333
BloodImage_00370.jpg,329.jpg,RBC,95,253,205,355,1,110,102,150,304,0.234375,0.6333333333333333,0.171875,0.2125
BloodImage_00370.jpg,329.jpg,RBC,24,327,138,423,1,114,96,81,375,0.1265625,0.78125,0.178125,0.2
BloodImage_00370.jpg,329.jpg,RBC,151,350,264,434,1,113,84,207,392,0.3234375,0.8166666666666667,0.1765625,0.175
BloodImage_00370.jpg,329.jpg,RBC,242,346,358,440,1,116,94,300,393,0.46875,0.81875,0.18125,0.19583333333333333
BloodImage_00370.jpg,329.jpg,RBC,362,348,468,458,1,106,110,415,403,0.6484375,0.8395833333333333,0.165625,0.22916666666666666
BloodImage_00370.jpg,329.jpg,RBC,442,353,543,436,1,101,83,492,394,0.76875,0.8208333333333333,0.1578125,0.17291666666666666
BloodImage_00370.jpg,329.jpg,RBC,452,246,552,354,1,100,108,502,300,0.784375,0.625,0.15625,0.225
BloodImage_00370.jpg,329.jpg,RBC,494,213,617,290,1,123,77,555,251,0.8671875,0.5229166666666667,0.1921875,0.16041666666666668
BloodImage_00370.jpg,329.jpg,RBC,473,127,597,208,1,124,81,535,167,0.8359375,0.34791666666666665,0.19375,0.16875
BloodImage_00370.jpg,329.jpg,RBC,323,47,433,143,1,110,96,378,95,0.590625,0.19791666666666666,0.171875,0.2
BloodImage_00370.jpg,329.jpg,RBC,483,1,597,117,1,114,116,540,59,0.84375,0.12291666666666666,0.178125,0.24166666666666667
BloodImage_00370.jpg,329.jpg,RBC,173,83,294,216,1,121,133,233,149,0.3640625,0.3104166666666667,0.1890625,0.27708333333333335
BloodImage_00370.jpg,329.jpg,WBC,240,126,465,345,2,225,219,352,235,0.55,0.4895833333333333,0.3515625,0.45625
BloodImage_00371.jpg,330.jpg,RBC,39,369,140,467,1,101,98,89,418,0.1390625,0.8708333333333333,0.1578125,0.20416666666666666
BloodImage_00371.jpg,330.jpg,RBC,12,284,109,380,1,97,96,60,332,0.09375,0.6916666666666667,0.1515625,0.2
BloodImage_00371.jpg,330.jpg,RBC,530,207,640,300,1,110,93,585,253,0.9140625,0.5270833333333333,0.171875,0.19375
BloodImage_00371.jpg,330.jpg,RBC,298,249,400,368,1,102,119,349,308,0.5453125,0.6416666666666667,0.159375,0.24791666666666667
BloodImage_00371.jpg,330.jpg,RBC,390,39,490,156,1,100,117,440,97,0.6875,0.20208333333333334,0.15625,0.24375
BloodImage_00371.jpg,330.jpg,RBC,79,11,179,105,1,100,94,129,58,0.2015625,0.12083333333333333,0.15625,0.19583333333333333
BloodImage_00371.jpg,330.jpg,RBC,384,264,499,354,1,115,90,441,309,0.6890625,0.64375,0.1796875,0.1875
BloodImage_00371.jpg,330.jpg,RBC,10,83,111,182,1,101,99,60,132,0.09375,0.275,0.1578125,0.20625
BloodImage_00371.jpg,330.jpg,RBC,48,151,151,253,1,103,102,99,202,0.1546875,0.42083333333333334,0.1609375,0.2125
BloodImage_00371.jpg,330.jpg,RBC,173,275,272,373,1,99,98,222,324,0.346875,0.675,0.1546875,0.20416666666666666
BloodImage_00371.jpg,330.jpg,RBC,523,370,629,472,1,106,102,576,421,0.9,0.8770833333333333,0.165625,0.2125
BloodImage_00371.jpg,330.jpg,RBC,182,10,278,94,1,96,84,230,52,0.359375,0.10833333333333334,0.15,0.175
BloodImage_00371.jpg,330.jpg,WBC,175,87,389,298,2,214,211,282,192,0.440625,0.4,0.334375,0.4395833333333333
BloodImage_00372.jpg,331.jpg,RBC,134,247,249,359,1,115,112,191,303,0.2984375,0.63125,0.1796875,0.23333333333333334
BloodImage_00372.jpg,331.jpg,RBC,356,62,471,174,1,115,112,413,118,0.6453125,0.24583333333333332,0.1796875,0.23333333333333334
BloodImage_00372.jpg,331.jpg,RBC,404,287,519,399,1,115,112,461,343,0.7203125,0.7145833333333333,0.1796875,0.23333333333333334
BloodImage_00372.jpg,331.jpg,RBC,324,178,397,295,1,73,117,360,236,0.5625,0.49166666666666664,0.1140625,0.24375
BloodImage_00372.jpg,331.jpg,RBC,143,131,267,246,1,124,115,205,188,0.3203125,0.39166666666666666,0.19375,0.23958333333333334
BloodImage_00372.jpg,331.jpg,RBC,276,364,383,472,1,107,108,329,418,0.5140625,0.8708333333333333,0.1671875,0.225
BloodImage_00372.jpg,331.jpg,RBC,144,353,272,451,1,128,98,208,402,0.325,0.8375,0.2,0.20416666666666666
BloodImage_00372.jpg,331.jpg,RBC,498,211,613,323,1,115,112,555,267,0.8671875,0.55625,0.1796875,0.23333333333333334
BloodImage_00372.jpg,331.jpg,RBC,483,377,583,480,1,100,103,533,428,0.8328125,0.8916666666666667,0.15625,0.21458333333333332
BloodImage_00372.jpg,331.jpg,RBC,325,1,441,73,1,116,72,383,37,0.5984375,0.07708333333333334,0.18125,0.15
BloodImage_00372.jpg,331.jpg,RBC,257,180,372,290,1,115,110,314,235,0.490625,0.4895833333333333,0.1796875,0.22916666666666666
BloodImage_00372.jpg,331.jpg,RBC,66,349,188,446,1,122,97,127,397,0.1984375,0.8270833333333333,0.190625,0.20208333333333334
BloodImage_00372.jpg,331.jpg,WBC,132,1,349,159,2,217,158,240,80,0.375,0.16666666666666666,0.3390625,0.32916666666666666
BloodImage_00374.jpg,332.jpg,RBC,241,95,358,213,1,117,118,299,154,0.4671875,0.32083333333333336,0.1828125,0.24583333333333332
BloodImage_00374.jpg,332.jpg,RBC,387,296,504,414,1,117,118,445,355,0.6953125,0.7395833333333334,0.1828125,0.24583333333333332
BloodImage_00374.jpg,332.jpg,RBC,485,332,602,450,1,117,118,543,391,0.8484375,0.8145833333333333,0.1828125,0.24583333333333332
BloodImage_00374.jpg,332.jpg,RBC,526,127,640,226,1,114,99,583,176,0.9109375,0.36666666666666664,0.178125,0.20625
BloodImage_00374.jpg,332.jpg,RBC,555,225,640,344,1,85,119,597,284,0.9328125,0.5916666666666667,0.1328125,0.24791666666666667
BloodImage_00374.jpg,332.jpg,RBC,439,202,544,299,1,105,97,491,250,0.7671875,0.5208333333333334,0.1640625,0.20208333333333334
BloodImage_00374.jpg,332.jpg,RBC,407,89,512,186,1,105,97,459,137,0.7171875,0.28541666666666665,0.1640625,0.20208333333333334
BloodImage_00374.jpg,332.jpg,RBC,434,2,539,99,1,105,97,486,50,0.759375,0.10416666666666667,0.1640625,0.20208333333333334
BloodImage_00374.jpg,332.jpg,RBC,107,28,212,125,1,105,97,159,76,0.2484375,0.15833333333333333,0.1640625,0.20208333333333334
BloodImage_00374.jpg,332.jpg,WBC,185,282,403,480,2,218,198,294,381,0.459375,0.79375,0.340625,0.4125
BloodImage_00374.jpg,332.jpg,WBC,1,125,216,377,2,215,252,108,251,0.16875,0.5229166666666667,0.3359375,0.525
BloodImage_00375.jpg,333.jpg,RBC,77,250,177,343,1,100,93,127,296,0.1984375,0.6166666666666667,0.15625,0.19375
BloodImage_00375.jpg,333.jpg,RBC,183,297,270,391,1,87,94,226,344,0.353125,0.7166666666666667,0.1359375,0.19583333333333333
BloodImage_00375.jpg,333.jpg,RBC,259,294,356,400,1,97,106,307,347,0.4796875,0.7229166666666667,0.1515625,0.22083333333333333
BloodImage_00375.jpg,333.jpg,RBC,434,292,541,392,1,107,100,487,342,0.7609375,0.7125,0.1671875,0.20833333333333334
BloodImage_00375.jpg,333.jpg,RBC,520,273,628,389,1,108,116,574,331,0.896875,0.6895833333333333,0.16875,0.24166666666666667
BloodImage_00375.jpg,333.jpg,RBC,42,383,143,473,1,101,90,92,428,0.14375,0.8916666666666667,0.1578125,0.1875
BloodImage_00375.jpg,333.jpg,RBC,101,113,211,233,1,110,120,156,173,0.24375,0.36041666666666666,0.171875,0.25
BloodImage_00375.jpg,333.jpg,RBC,2,112,103,202,1,101,90,52,157,0.08125,0.32708333333333334,0.1578125,0.1875
BloodImage_00375.jpg,333.jpg,RBC,333,199,436,301,1,103,102,384,250,0.6,0.5208333333333334,0.1609375,0.2125
BloodImage_00375.jpg,333.jpg,RBC,429,160,531,247,1,102,87,480,203,0.75,0.42291666666666666,0.159375,0.18125
BloodImage_00375.jpg,333.jpg,RBC,534,37,636,124,1,102,87,585,80,0.9140625,0.16666666666666666,0.159375,0.18125
BloodImage_00375.jpg,333.jpg,RBC,38,11,149,112,1,111,101,93,61,0.1453125,0.12708333333333333,0.1734375,0.21041666666666667
BloodImage_00375.jpg,333.jpg,Platelets,377,425,421,470,0,44,45,399,447,0.6234375,0.93125,0.06875,0.09375
BloodImage_00375.jpg,333.jpg,WBC,211,1,420,167,2,209,166,315,84,0.4921875,0.175,0.3265625,0.3458333333333333
BloodImage_00375.jpg,333.jpg,Platelets,52,1,92,34,0,40,33,72,17,0.1125,0.035416666666666666,0.0625,0.06875
BloodImage_00376.jpg,334.jpg,RBC,259,64,383,166,1,124,102,321,115,0.5015625,0.23958333333333334,0.19375,0.2125
BloodImage_00376.jpg,334.jpg,RBC,168,290,279,398,1,111,108,223,344,0.3484375,0.7166666666666667,0.1734375,0.225
BloodImage_00376.jpg,334.jpg,RBC,278,188,370,299,1,92,111,324,243,0.50625,0.50625,0.14375,0.23125
BloodImage_00376.jpg,334.jpg,RBC,453,77,560,182,1,107,105,506,129,0.790625,0.26875,0.1671875,0.21875
BloodImage_00376.jpg,334.jpg,RBC,365,163,460,269,1,95,106,412,216,0.64375,0.45,0.1484375,0.22083333333333333
BloodImage_00376.jpg,334.jpg,RBC,82,7,177,113,1,95,106,129,60,0.2015625,0.125,0.1484375,0.22083333333333333
BloodImage_00376.jpg,334.jpg,RBC,1,237,72,366,1,71,129,36,301,0.05625,0.6270833333333333,0.1109375,0.26875
BloodImage_00376.jpg,334.jpg,RBC,536,160,637,277,1,101,117,586,218,0.915625,0.45416666666666666,0.1578125,0.24375
BloodImage_00376.jpg,334.jpg,RBC,321,289,407,383,1,86,94,364,336,0.56875,0.7,0.134375,0.19583333333333333
BloodImage_00376.jpg,334.jpg,RBC,46,401,158,480,1,112,79,102,440,0.159375,0.9166666666666666,0.175,0.16458333333333333
BloodImage_00376.jpg,334.jpg,WBC,374,277,605,480,2,231,203,489,378,0.7640625,0.7875,0.3609375,0.42291666666666666
BloodImage_00377.jpg,335.jpg,RBC,448,244,566,350,1,118,106,507,297,0.7921875,0.61875,0.184375,0.22083333333333333
BloodImage_00377.jpg,335.jpg,RBC,238,215,333,310,1,95,95,285,262,0.4453125,0.5458333333333333,0.1484375,0.19791666666666666
BloodImage_00377.jpg,335.jpg,RBC,15,280,103,406,1,88,126,59,343,0.0921875,0.7145833333333333,0.1375,0.2625
BloodImage_00377.jpg,335.jpg,RBC,239,70,353,167,1,114,97,296,118,0.4625,0.24583333333333332,0.178125,0.20208333333333334
BloodImage_00377.jpg,335.jpg,RBC,467,13,590,126,1,123,113,528,69,0.825,0.14375,0.1921875,0.23541666666666666
BloodImage_00377.jpg,335.jpg,RBC,412,130,520,236,1,108,106,466,183,0.728125,0.38125,0.16875,0.22083333333333333
BloodImage_00377.jpg,335.jpg,RBC,329,137,447,254,1,118,117,388,195,0.60625,0.40625,0.184375,0.24375
BloodImage_00377.jpg,335.jpg,RBC,355,385,474,480,1,119,95,414,432,0.646875,0.9,0.1859375,0.19791666666666666
BloodImage_00377.jpg,335.jpg,RBC,340,259,442,359,1,102,100,391,309,0.6109375,0.64375,0.159375,0.20833333333333334
BloodImage_00377.jpg,335.jpg,RBC,174,138,274,233,1,100,95,224,185,0.35,0.3854166666666667,0.15625,0.19791666666666666
BloodImage_00377.jpg,335.jpg,RBC,98,47,196,164,1,98,117,147,105,0.2296875,0.21875,0.153125,0.24375
BloodImage_00377.jpg,335.jpg,RBC,102,156,192,277,1,90,121,147,216,0.2296875,0.45,0.140625,0.2520833333333333
BloodImage_00377.jpg,335.jpg,RBC,161,1,271,77,1,110,76,216,39,0.3375,0.08125,0.171875,0.15833333333333333
BloodImage_00377.jpg,335.jpg,WBC,79,296,307,480,2,228,184,193,388,0.3015625,0.8083333333333333,0.35625,0.38333333333333336
BloodImage_00377.jpg,335.jpg,Platelets,536,102,574,140,0,38,38,555,121,0.8671875,0.2520833333333333,0.059375,0.07916666666666666
BloodImage_00377.jpg,335.jpg,Platelets,507,120,543,155,0,36,35,525,137,0.8203125,0.28541666666666665,0.05625,0.07291666666666667
BloodImage_00378.jpg,336.jpg,RBC,26,217,124,319,1,98,102,75,268,0.1171875,0.5583333333333333,0.153125,0.2125
BloodImage_00378.jpg,336.jpg,RBC,131,225,229,327,1,98,102,180,276,0.28125,0.575,0.153125,0.2125
BloodImage_00378.jpg,336.jpg,RBC,64,115,162,217,1,98,102,113,166,0.1765625,0.3458333333333333,0.153125,0.2125
BloodImage_00378.jpg,336.jpg,RBC,1,113,82,213,1,81,100,41,163,0.0640625,0.33958333333333335,0.1265625,0.20833333333333334
BloodImage_00378.jpg,336.jpg,RBC,265,173,360,271,1,95,98,312,222,0.4875,0.4625,0.1484375,0.20416666666666666
BloodImage_00378.jpg,336.jpg,RBC,166,131,292,222,1,126,91,229,176,0.3578125,0.36666666666666664,0.196875,0.18958333333333333
BloodImage_00378.jpg,336.jpg,RBC,138,64,256,137,1,118,73,197,100,0.3078125,0.20833333333333334,0.184375,0.15208333333333332
BloodImage_00378.jpg,336.jpg,RBC,34,1,150,81,1,116,80,92,41,0.14375,0.08541666666666667,0.18125,0.16666666666666666
BloodImage_00378.jpg,336.jpg,RBC,462,54,592,162,1,130,108,527,108,0.8234375,0.225,0.203125,0.225
BloodImage_00378.jpg,336.jpg,RBC,345,1,471,74,1,126,73,408,37,0.6375,0.07708333333333334,0.196875,0.15208333333333332
BloodImage_00378.jpg,336.jpg,RBC,248,71,349,173,1,101,102,298,122,0.465625,0.25416666666666665,0.1578125,0.2125
BloodImage_00378.jpg,336.jpg,RBC,420,181,524,299,1,104,118,472,240,0.7375,0.5,0.1625,0.24583333333333332
BloodImage_00378.jpg,336.jpg,RBC,478,167,582,269,1,104,102,530,218,0.828125,0.45416666666666666,0.1625,0.2125
BloodImage_00378.jpg,336.jpg,RBC,69,369,167,471,1,98,102,118,420,0.184375,0.875,0.153125,0.2125
BloodImage_00378.jpg,336.jpg,RBC,376,293,474,395,1,98,102,425,344,0.6640625,0.7166666666666667,0.153125,0.2125
BloodImage_00378.jpg,336.jpg,WBC,171,285,399,480,2,228,195,285,382,0.4453125,0.7958333333333333,0.35625,0.40625
BloodImage_00379.jpg,337.jpg,RBC,437,29,531,114,1,94,85,484,71,0.75625,0.14791666666666667,0.146875,0.17708333333333334
BloodImage_00379.jpg,337.jpg,RBC,279,58,384,155,1,105,97,331,106,0.5171875,0.22083333333333333,0.1640625,0.20208333333333334
BloodImage_00379.jpg,337.jpg,RBC,133,96,237,179,1,104,83,185,137,0.2890625,0.28541666666666665,0.1625,0.17291666666666666
BloodImage_00379.jpg,337.jpg,RBC,23,67,102,192,1,79,125,62,129,0.096875,0.26875,0.1234375,0.2604166666666667
BloodImage_00379.jpg,337.jpg,RBC,488,147,603,275,1,115,128,545,211,0.8515625,0.4395833333333333,0.1796875,0.26666666666666666
BloodImage_00379.jpg,337.jpg,RBC,291,158,396,255,1,105,97,343,206,0.5359375,0.42916666666666664,0.1640625,0.20208333333333334
BloodImage_00379.jpg,337.jpg,RBC,226,162,318,259,1,92,97,272,210,0.425,0.4375,0.14375,0.20208333333333334
BloodImage_00379.jpg,337.jpg,RBC,271,320,376,417,1,105,97,323,368,0.5046875,0.7666666666666667,0.1640625,0.20208333333333334
BloodImage_00379.jpg,337.jpg,RBC,319,258,434,358,1,115,100,376,308,0.5875,0.6416666666666667,0.1796875,0.20833333333333334
BloodImage_00379.jpg,337.jpg,RBC,385,213,500,313,1,115,100,442,263,0.690625,0.5479166666666667,0.1796875,0.20833333333333334
BloodImage_00379.jpg,337.jpg,RBC,501,301,616,401,1,115,100,558,351,0.871875,0.73125,0.1796875,0.20833333333333334
BloodImage_00379.jpg,337.jpg,RBC,117,174,214,265,1,97,91,165,219,0.2578125,0.45625,0.1515625,0.18958333333333333
BloodImage_00379.jpg,337.jpg,RBC,73,184,170,275,1,97,91,121,229,0.1890625,0.47708333333333336,0.1515625,0.18958333333333333
BloodImage_00379.jpg,337.jpg,RBC,105,273,222,368,1,117,95,163,320,0.2546875,0.6666666666666666,0.1828125,0.19791666666666666
BloodImage_00379.jpg,337.jpg,RBC,187,368,304,463,1,117,95,245,415,0.3828125,0.8645833333333334,0.1828125,0.19791666666666666
BloodImage_00379.jpg,337.jpg,RBC,159,1,303,96,1,144,95,231,48,0.3609375,0.1,0.225,0.19791666666666666
BloodImage_00379.jpg,337.jpg,RBC,417,314,511,399,1,94,85,464,356,0.725,0.7416666666666667,0.146875,0.17708333333333334
BloodImage_00379.jpg,337.jpg,RBC,404,365,498,450,1,94,85,451,407,0.7046875,0.8479166666666667,0.146875,0.17708333333333334
BloodImage_00379.jpg,337.jpg,WBC,22,384,219,480,2,197,96,120,432,0.1875,0.9,0.3078125,0.2
BloodImage_00381.jpg,338.jpg,RBC,208,290,310,380,1,102,90,259,335,0.4046875,0.6979166666666666,0.159375,0.1875
BloodImage_00381.jpg,338.jpg,RBC,313,310,423,401,1,110,91,368,355,0.575,0.7395833333333334,0.171875,0.18958333333333333
BloodImage_00381.jpg,338.jpg,RBC,469,338,579,443,1,110,105,524,390,0.81875,0.8125,0.171875,0.21875
BloodImage_00381.jpg,338.jpg,RBC,530,169,640,274,1,110,105,585,221,0.9140625,0.46041666666666664,0.171875,0.21875
BloodImage_00381.jpg,338.jpg,RBC,211,166,321,271,1,110,105,266,218,0.415625,0.45416666666666666,0.171875,0.21875
BloodImage_00381.jpg,338.jpg,RBC,207,64,317,169,1,110,105,262,116,0.409375,0.24166666666666667,0.171875,0.21875
BloodImage_00381.jpg,338.jpg,RBC,292,34,414,154,1,122,120,353,94,0.5515625,0.19583333333333333,0.190625,0.25
BloodImage_00381.jpg,338.jpg,RBC,367,139,471,240,1,104,101,419,189,0.6546875,0.39375,0.1625,0.21041666666666667
BloodImage_00381.jpg,338.jpg,RBC,425,106,539,223,1,114,117,482,164,0.753125,0.3416666666666667,0.178125,0.24375
BloodImage_00381.jpg,338.jpg,RBC,417,233,531,319,1,114,86,474,276,0.740625,0.575,0.178125,0.17916666666666667
BloodImage_00381.jpg,338.jpg,RBC,455,1,574,101,1,119,100,514,51,0.803125,0.10625,0.1859375,0.20833333333333334
BloodImage_00381.jpg,338.jpg,RBC,139,86,229,191,1,90,105,184,138,0.2875,0.2875,0.140625,0.21875
BloodImage_00381.jpg,338.jpg,RBC,1,103,101,207,1,100,104,51,155,0.0796875,0.3229166666666667,0.15625,0.21666666666666667
BloodImage_00381.jpg,338.jpg,RBC,10,200,110,298,1,100,98,60,249,0.09375,0.51875,0.15625,0.20416666666666666
BloodImage_00381.jpg,338.jpg,RBC,416,249,500,362,1,84,113,458,305,0.715625,0.6354166666666666,0.13125,0.23541666666666666
BloodImage_00381.jpg,338.jpg,WBC,10,291,236,480,2,226,189,123,385,0.1921875,0.8020833333333334,0.353125,0.39375
BloodImage_00382.jpg,339.jpg,RBC,1,345,70,441,1,69,96,35,393,0.0546875,0.81875,0.1078125,0.2
BloodImage_00382.jpg,339.jpg,RBC,37,271,143,376,1,106,105,90,323,0.140625,0.6729166666666667,0.165625,0.21875
BloodImage_00382.jpg,339.jpg,RBC,125,217,231,322,1,106,105,178,269,0.278125,0.5604166666666667,0.165625,0.21875
BloodImage_00382.jpg,339.jpg,RBC,142,367,248,472,1,106,105,195,419,0.3046875,0.8729166666666667,0.165625,0.21875
BloodImage_00382.jpg,339.jpg,RBC,218,296,315,391,1,97,95,266,343,0.415625,0.7145833333333333,0.1515625,0.19791666666666666
BloodImage_00382.jpg,339.jpg,RBC,283,368,377,478,1,94,110,330,423,0.515625,0.88125,0.146875,0.22916666666666666
BloodImage_00382.jpg,339.jpg,RBC,438,250,552,358,1,114,108,495,304,0.7734375,0.6333333333333333,0.178125,0.225
BloodImage_00382.jpg,339.jpg,RBC,411,133,523,243,1,112,110,467,188,0.7296875,0.39166666666666666,0.175,0.22916666666666666
BloodImage_00382.jpg,339.jpg,RBC,70,49,175,159,1,105,110,122,104,0.190625,0.21666666666666667,0.1640625,0.22916666666666666
BloodImage_00382.jpg,339.jpg,RBC,430,13,535,123,1,105,110,482,68,0.753125,0.14166666666666666,0.1640625,0.22916666666666666
BloodImage_00382.jpg,339.jpg,RBC,319,258,433,366,1,114,108,376,312,0.5875,0.65,0.178125,0.225
BloodImage_00382.jpg,339.jpg,RBC,420,386,522,480,1,102,94,471,433,0.7359375,0.9020833333333333,0.159375,0.19583333333333333
BloodImage_00382.jpg,339.jpg,RBC,559,330,640,439,1,81,109,599,384,0.9359375,0.8,0.1265625,0.22708333333333333
BloodImage_00382.jpg,339.jpg,WBC,158,35,389,259,2,231,224,273,147,0.4265625,0.30625,0.3609375,0.4666666666666667
BloodImage_00382.jpg,339.jpg,Platelets,519,154,598,224,0,79,70,558,189,0.871875,0.39375,0.1234375,0.14583333333333334
BloodImage_00382.jpg,339.jpg,Platelets,517,1,563,37,0,46,36,540,19,0.84375,0.03958333333333333,0.071875,0.075
BloodImage_00383.jpg,340.jpg,RBC,64,264,174,351,1,110,87,119,307,0.1859375,0.6395833333333333,0.171875,0.18125
BloodImage_00383.jpg,340.jpg,RBC,387,92,496,212,1,109,120,441,152,0.6890625,0.31666666666666665,0.1703125,0.25
BloodImage_00383.jpg,340.jpg,RBC,522,208,631,328,1,109,120,576,268,0.9,0.5583333333333333,0.1703125,0.25
BloodImage_00383.jpg,340.jpg,RBC,1,42,92,162,1,91,120,46,102,0.071875,0.2125,0.1421875,0.25
BloodImage_00383.jpg,340.jpg,RBC,76,67,193,183,1,117,116,134,125,0.209375,0.2604166666666667,0.1828125,0.24166666666666667
BloodImage_00383.jpg,340.jpg,RBC,57,138,174,254,1,117,116,115,196,0.1796875,0.4083333333333333,0.1828125,0.24166666666666667
BloodImage_00383.jpg,340.jpg,RBC,1,346,104,454,1,103,108,52,400,0.08125,0.8333333333333334,0.1609375,0.225
BloodImage_00383.jpg,340.jpg,RBC,309,1,419,87,1,110,86,364,44,0.56875,0.09166666666666666,0.171875,0.17916666666666667
BloodImage_00383.jpg,340.jpg,Platelets,19,226,70,272,0,51,46,44,249,0.06875,0.51875,0.0796875,0.09583333333333334
BloodImage_00383.jpg,340.jpg,Platelets,182,213,232,253,0,50,40,207,233,0.3234375,0.48541666666666666,0.078125,0.08333333333333333
BloodImage_00383.jpg,340.jpg,Platelets,31,1,73,28,0,42,27,52,14,0.08125,0.029166666666666667,0.065625,0.05625
BloodImage_00383.jpg,340.jpg,WBC,225,217,531,480,2,306,263,378,348,0.590625,0.725,0.478125,0.5479166666666667
BloodImage_00384.jpg,341.jpg,RBC,173,274,305,360,1,132,86,239,317,0.3734375,0.6604166666666667,0.20625,0.17916666666666667
BloodImage_00384.jpg,341.jpg,RBC,112,349,236,473,1,124,124,174,411,0.271875,0.85625,0.19375,0.25833333333333336
BloodImage_00384.jpg,341.jpg,RBC,108,77,232,201,1,124,124,170,139,0.265625,0.28958333333333336,0.19375,0.25833333333333336
BloodImage_00384.jpg,341.jpg,RBC,300,93,423,207,1,123,114,361,150,0.5640625,0.3125,0.1921875,0.2375
BloodImage_00384.jpg,341.jpg,RBC,350,1,478,101,1,128,100,414,51,0.646875,0.10625,0.2,0.20833333333333334
BloodImage_00384.jpg,341.jpg,RBC,291,201,403,314,1,112,113,347,257,0.5421875,0.5354166666666667,0.175,0.23541666666666666
BloodImage_00384.jpg,341.jpg,RBC,317,321,455,445,1,138,124,386,383,0.603125,0.7979166666666667,0.215625,0.25833333333333336
BloodImage_00384.jpg,341.jpg,RBC,434,89,568,185,1,134,96,501,137,0.7828125,0.28541666666666665,0.209375,0.2
BloodImage_00384.jpg,341.jpg,RBC,540,103,640,218,1,100,115,590,160,0.921875,0.3333333333333333,0.15625,0.23958333333333334
BloodImage_00384.jpg,341.jpg,RBC,95,1,200,74,1,105,73,147,37,0.2296875,0.07708333333333334,0.1640625,0.15208333333333332
BloodImage_00384.jpg,341.jpg,WBC,393,175,597,391,2,204,216,495,283,0.7734375,0.5895833333333333,0.31875,0.45
BloodImage_00385.jpg,342.jpg,RBC,421,185,538,289,1,117,104,479,237,0.7484375,0.49375,0.1828125,0.21666666666666667
BloodImage_00385.jpg,342.jpg,RBC,149,207,266,311,1,117,104,207,259,0.3234375,0.5395833333333333,0.1828125,0.21666666666666667
BloodImage_00385.jpg,342.jpg,RBC,86,143,169,231,1,83,88,127,187,0.1984375,0.38958333333333334,0.1296875,0.18333333333333332
BloodImage_00385.jpg,342.jpg,RBC,98,17,209,137,1,111,120,153,77,0.2390625,0.16041666666666668,0.1734375,0.25
BloodImage_00385.jpg,342.jpg,RBC,1,1,107,109,1,106,108,54,55,0.084375,0.11458333333333333,0.165625,0.225
BloodImage_00385.jpg,342.jpg,RBC,10,250,125,362,1,115,112,67,306,0.1046875,0.6375,0.1796875,0.23333333333333334
BloodImage_00385.jpg,342.jpg,RBC,1,367,115,480,1,114,113,58,423,0.090625,0.88125,0.178125,0.23541666666666666
BloodImage_00385.jpg,342.jpg,RBC,129,324,227,423,1,98,99,178,373,0.278125,0.7770833333333333,0.153125,0.20625
BloodImage_00385.jpg,342.jpg,RBC,290,211,407,315,1,117,104,348,263,0.54375,0.5479166666666667,0.1828125,0.21666666666666667
BloodImage_00385.jpg,342.jpg,RBC,485,1,602,104,1,117,103,543,52,0.8484375,0.10833333333333334,0.1828125,0.21458333333333332
BloodImage_00385.jpg,342.jpg,RBC,368,1,482,79,1,114,78,425,40,0.6640625,0.08333333333333333,0.178125,0.1625
BloodImage_00385.jpg,342.jpg,RBC,436,332,538,436,1,102,104,487,384,0.7609375,0.8,0.159375,0.21666666666666667
BloodImage_00385.jpg,342.jpg,RBC,567,299,640,404,1,73,105,603,351,0.9421875,0.73125,0.1140625,0.21875
BloodImage_00385.jpg,342.jpg,RBC,265,102,390,220,1,125,118,327,161,0.5109375,0.33541666666666664,0.1953125,0.24583333333333332
BloodImage_00385.jpg,342.jpg,WBC,218,303,443,480,2,225,177,330,391,0.515625,0.8145833333333333,0.3515625,0.36875
BloodImage_00385.jpg,342.jpg,Platelets,186,85,245,141,0,59,56,215,113,0.3359375,0.23541666666666666,0.0921875,0.11666666666666667
BloodImage_00385.jpg,342.jpg,Platelets,206,1,258,54,0,52,53,232,27,0.3625,0.05625,0.08125,0.11041666666666666
BloodImage_00385.jpg,342.jpg,Platelets,1,342,27,380,0,26,38,14,361,0.021875,0.7520833333333333,0.040625,0.07916666666666666
BloodImage_00386.jpg,343.jpg,RBC,1,305,106,423,1,105,118,53,364,0.0828125,0.7583333333333333,0.1640625,0.24583333333333332
BloodImage_00386.jpg,343.jpg,RBC,197,72,297,163,1,100,91,247,117,0.3859375,0.24375,0.15625,0.18958333333333333
BloodImage_00386.jpg,343.jpg,RBC,288,352,394,470,1,106,118,341,411,0.5328125,0.85625,0.165625,0.24583333333333332
BloodImage_00386.jpg,343.jpg,RBC,467,235,592,356,1,125,121,529,295,0.8265625,0.6145833333333334,0.1953125,0.2520833333333333
BloodImage_00386.jpg,343.jpg,RBC,443,390,543,479,1,100,89,493,434,0.7703125,0.9041666666666667,0.15625,0.18541666666666667
BloodImage_00386.jpg,343.jpg,RBC,443,32,541,140,1,98,108,492,86,0.76875,0.17916666666666667,0.153125,0.225
BloodImage_00386.jpg,343.jpg,RBC,532,20,640,145,1,108,125,586,82,0.915625,0.17083333333333334,0.16875,0.2604166666666667
BloodImage_00386.jpg,343.jpg,RBC,449,150,575,248,1,126,98,512,199,0.8,0.41458333333333336,0.196875,0.20416666666666666
BloodImage_00386.jpg,343.jpg,RBC,320,1,446,98,1,126,97,383,49,0.5984375,0.10208333333333333,0.196875,0.20208333333333334
BloodImage_00386.jpg,343.jpg,RBC,324,93,450,191,1,126,98,387,142,0.6046875,0.29583333333333334,0.196875,0.20416666666666666
BloodImage_00386.jpg,343.jpg,RBC,329,195,455,293,1,126,98,392,244,0.6125,0.5083333333333333,0.196875,0.20416666666666666
BloodImage_00386.jpg,343.jpg,RBC,115,307,241,405,1,126,98,178,356,0.278125,0.7416666666666667,0.196875,0.20416666666666666
BloodImage_00386.jpg,343.jpg,RBC,154,405,274,480,1,120,75,214,442,0.334375,0.9208333333333333,0.1875,0.15625
BloodImage_00386.jpg,343.jpg,RBC,1,102,123,213,1,122,111,62,157,0.096875,0.32708333333333334,0.190625,0.23125
BloodImage_00386.jpg,343.jpg,WBC,153,159,377,385,2,224,226,265,272,0.4140625,0.5666666666666667,0.35,0.4708333333333333
BloodImage_00387.jpg,344.jpg,RBC,54,262,161,385,1,107,123,107,323,0.1671875,0.6729166666666667,0.1671875,0.25625
BloodImage_00387.jpg,344.jpg,RBC,278,49,385,172,1,107,123,331,110,0.5171875,0.22916666666666666,0.1671875,0.25625
BloodImage_00387.jpg,344.jpg,RBC,149,159,283,258,1,134,99,216,208,0.3375,0.43333333333333335,0.209375,0.20625
BloodImage_00387.jpg,344.jpg,RBC,456,215,553,315,1,97,100,504,265,0.7875,0.5520833333333334,0.1515625,0.20833333333333334
BloodImage_00387.jpg,344.jpg,RBC,508,149,605,249,1,97,100,556,199,0.86875,0.41458333333333336,0.1515625,0.20833333333333334
BloodImage_00387.jpg,344.jpg,RBC,438,17,540,147,1,102,130,489,82,0.7640625,0.17083333333333334,0.159375,0.2708333333333333
BloodImage_00387.jpg,344.jpg,RBC,1,71,113,196,1,112,125,57,133,0.0890625,0.27708333333333335,0.175,0.2604166666666667
BloodImage_00387.jpg,344.jpg,RBC,64,1,168,94,1,104,93,116,47,0.18125,0.09791666666666667,0.1625,0.19375
BloodImage_00387.jpg,344.jpg,RBC,543,65,640,165,1,97,100,591,115,0.9234375,0.23958333333333334,0.1515625,0.20833333333333334
BloodImage_00387.jpg,344.jpg,RBC,543,258,640,364,1,97,106,591,311,0.9234375,0.6479166666666667,0.1515625,0.22083333333333333
BloodImage_00387.jpg,344.jpg,WBC,202,236,430,478,2,228,242,316,357,0.49375,0.74375,0.35625,0.5041666666666667
BloodImage_00387.jpg,344.jpg,Platelets,167,355,206,391,0,39,36,186,373,0.290625,0.7770833333333333,0.0609375,0.075
BloodImage_00387.jpg,344.jpg,Platelets,62,177,115,224,0,53,47,88,200,0.1375,0.4166666666666667,0.0828125,0.09791666666666667
BloodImage_00388.jpg,345.jpg,RBC,397,165,547,278,1,150,113,472,221,0.7375,0.46041666666666664,0.234375,0.23541666666666666
BloodImage_00388.jpg,345.jpg,RBC,352,269,483,395,1,131,126,417,332,0.6515625,0.6916666666666667,0.2046875,0.2625
BloodImage_00388.jpg,345.jpg,RBC,284,375,395,480,1,111,105,339,427,0.5296875,0.8895833333333333,0.1734375,0.21875
BloodImage_00388.jpg,345.jpg,RBC,184,316,289,434,1,105,118,236,375,0.36875,0.78125,0.1640625,0.24583333333333332
BloodImage_00388.jpg,345.jpg,RBC,146,229,251,347,1,105,118,198,288,0.309375,0.6,0.1640625,0.24583333333333332
BloodImage_00388.jpg,345.jpg,RBC,52,278,150,395,1,98,117,101,336,0.1578125,0.7,0.153125,0.24375
BloodImage_00388.jpg,345.jpg,RBC,100,133,238,228,1,138,95,169,180,0.2640625,0.375,0.215625,0.19791666666666666
BloodImage_00388.jpg,345.jpg,RBC,204,55,300,157,1,96,102,252,106,0.39375,0.22083333333333333,0.15,0.2125
BloodImage_00388.jpg,345.jpg,RBC,394,38,504,130,1,110,92,449,84,0.7015625,0.175,0.171875,0.19166666666666668
BloodImage_00388.jpg,345.jpg,RBC,450,411,557,480,1,107,69,503,445,0.7859375,0.9270833333333334,0.1671875,0.14375
BloodImage_00388.jpg,345.jpg,WBC,25,1,264,113,2,239,112,144,57,0.225,0.11875,0.3734375,0.23333333333333334
BloodImage_00389.jpg,346.jpg,RBC,191,367,300,479,1,109,112,245,423,0.3828125,0.88125,0.1703125,0.23333333333333334
BloodImage_00389.jpg,346.jpg,RBC,406,366,515,478,1,109,112,460,422,0.71875,0.8791666666666667,0.1703125,0.23333333333333334
BloodImage_00389.jpg,346.jpg,RBC,93,208,212,324,1,119,116,152,266,0.2375,0.5541666666666667,0.1859375,0.24166666666666667
BloodImage_00389.jpg,346.jpg,RBC,305,79,424,195,1,119,116,364,137,0.56875,0.28541666666666665,0.1859375,0.24166666666666667
BloodImage_00389.jpg,346.jpg,RBC,529,197,640,311,1,111,114,584,254,0.9125,0.5291666666666667,0.1734375,0.2375
BloodImage_00389.jpg,346.jpg,WBC,1,11,222,221,2,221,210,111,116,0.1734375,0.24166666666666667,0.3453125,0.4375
BloodImage_00389.jpg,346.jpg,Platelets,216,113,249,153,0,33,40,232,133,0.3625,0.27708333333333335,0.0515625,0.08333333333333333
BloodImage_00389.jpg,346.jpg,Platelets,292,130,323,164,0,31,34,307,147,0.4796875,0.30625,0.0484375,0.07083333333333333
BloodImage_00390.jpg,347.jpg,RBC,30,213,160,306,1,130,93,95,259,0.1484375,0.5395833333333333,0.203125,0.19375
BloodImage_00390.jpg,347.jpg,RBC,1,386,85,477,1,84,91,43,431,0.0671875,0.8979166666666667,0.13125,0.18958333333333333
BloodImage_00390.jpg,347.jpg,RBC,73,320,177,424,1,104,104,125,372,0.1953125,0.775,0.1625,0.21666666666666667
BloodImage_00390.jpg,347.jpg,RBC,496,46,610,169,1,114,123,553,107,0.8640625,0.22291666666666668,0.178125,0.25625
BloodImage_00390.jpg,347.jpg,RBC,344,47,465,196,1,121,149,404,121,0.63125,0.2520833333333333,0.1890625,0.3104166666666667
BloodImage_00390.jpg,347.jpg,RBC,555,135,640,247,1,85,112,597,191,0.9328125,0.39791666666666664,0.1328125,0.23333333333333334
BloodImage_00390.jpg,347.jpg,RBC,534,357,640,480,1,106,123,587,418,0.9171875,0.8708333333333333,0.165625,0.25625
BloodImage_00390.jpg,347.jpg,RBC,338,228,452,351,1,114,123,395,289,0.6171875,0.6020833333333333,0.178125,0.25625
BloodImage_00390.jpg,347.jpg,RBC,344,357,458,480,1,114,123,401,418,0.6265625,0.8708333333333333,0.178125,0.25625
BloodImage_00390.jpg,347.jpg,RBC,202,112,341,259,1,139,147,271,185,0.4234375,0.3854166666666667,0.2171875,0.30625
BloodImage_00390.jpg,347.jpg,WBC,147,304,368,480,2,221,176,257,392,0.4015625,0.8166666666666667,0.3453125,0.36666666666666664
BloodImage_00391.jpg,348.jpg,RBC,19,312,133,440,1,114,128,76,376,0.11875,0.7833333333333333,0.178125,0.26666666666666666
BloodImage_00391.jpg,348.jpg,RBC,308,365,422,480,1,114,115,365,422,0.5703125,0.8791666666666667,0.178125,0.23958333333333334
BloodImage_00391.jpg,348.jpg,RBC,500,244,619,359,1,119,115,559,301,0.8734375,0.6270833333333333,0.1859375,0.23958333333333334
BloodImage_00391.jpg,348.jpg,RBC,474,151,600,257,1,126,106,537,204,0.8390625,0.425,0.196875,0.22083333333333333
BloodImage_00391.jpg,348.jpg,RBC,565,26,640,152,1,75,126,602,89,0.940625,0.18541666666666667,0.1171875,0.2625
BloodImage_00391.jpg,348.jpg,RBC,472,33,565,149,1,93,116,518,91,0.809375,0.18958333333333333,0.1453125,0.24166666666666667
BloodImage_00391.jpg,348.jpg,RBC,346,1,472,106,1,126,105,409,53,0.6390625,0.11041666666666666,0.196875,0.21875
BloodImage_00391.jpg,348.jpg,RBC,356,104,473,197,1,117,93,414,150,0.646875,0.3125,0.1828125,0.19375
BloodImage_00391.jpg,348.jpg,RBC,217,85,334,178,1,117,93,275,131,0.4296875,0.27291666666666664,0.1828125,0.19375
BloodImage_00391.jpg,348.jpg,RBC,378,205,474,304,1,96,99,426,254,0.665625,0.5291666666666667,0.15,0.20625
BloodImage_00391.jpg,348.jpg,RBC,467,395,567,480,1,100,85,517,437,0.8078125,0.9104166666666667,0.15625,0.17708333333333334
BloodImage_00391.jpg,348.jpg,RBC,190,408,291,480,1,101,72,240,444,0.375,0.925,0.1578125,0.15
BloodImage_00391.jpg,348.jpg,RBC,149,317,260,411,1,111,94,204,364,0.31875,0.7583333333333333,0.1734375,0.19583333333333333
BloodImage_00391.jpg,348.jpg,RBC,1,109,129,220,1,128,111,65,164,0.1015625,0.3416666666666667,0.2,0.23125
BloodImage_00391.jpg,348.jpg,WBC,207,160,418,388,2,211,228,312,274,0.4875,0.5708333333333333,0.3296875,0.475
BloodImage_00392.jpg,349.jpg,RBC,135,331,265,453,1,130,122,200,392,0.3125,0.8166666666666667,0.203125,0.25416666666666665
BloodImage_00392.jpg,349.jpg,RBC,379,118,509,240,1,130,122,444,179,0.69375,0.3729166666666667,0.203125,0.25416666666666665
BloodImage_00392.jpg,349.jpg,RBC,496,74,626,196,1,130,122,561,135,0.8765625,0.28125,0.203125,0.25416666666666665
BloodImage_00392.jpg,349.jpg,RBC,537,218,640,322,1,103,104,588,270,0.91875,0.5625,0.1609375,0.21666666666666667
BloodImage_00392.jpg,349.jpg,RBC,505,322,614,434,1,109,112,559,378,0.8734375,0.7875,0.1703125,0.23333333333333334
BloodImage_00392.jpg,349.jpg,RBC,400,363,509,475,1,109,112,454,419,0.709375,0.8729166666666667,0.1703125,0.23333333333333334
BloodImage_00392.jpg,349.jpg,RBC,286,365,395,477,1,109,112,340,421,0.53125,0.8770833333333333,0.1703125,0.23333333333333334
BloodImage_00392.jpg,349.jpg,RBC,258,281,397,381,1,139,100,327,331,0.5109375,0.6895833333333333,0.2171875,0.20833333333333334
BloodImage_00392.jpg,349.jpg,RBC,1,139,119,261,1,118,122,60,200,0.09375,0.4166666666666667,0.184375,0.25416666666666665
BloodImage_00392.jpg,349.jpg,RBC,111,241,231,332,1,120,91,171,286,0.2671875,0.5958333333333333,0.1875,0.18958333333333333
BloodImage_00392.jpg,349.jpg,RBC,298,20,392,122,1,94,102,345,71,0.5390625,0.14791666666666667,0.146875,0.2125
BloodImage_00392.jpg,349.jpg,RBC,11,52,128,159,1,117,107,69,105,0.1078125,0.21875,0.1828125,0.22291666666666668
BloodImage_00392.jpg,349.jpg,RBC,191,1,292,78,1,101,77,241,39,0.3765625,0.08125,0.1578125,0.16041666666666668
BloodImage_00392.jpg,349.jpg,RBC,414,1,515,78,1,101,77,464,39,0.725,0.08125,0.1578125,0.16041666666666668
BloodImage_00392.jpg,349.jpg,WBC,128,67,410,296,2,282,229,269,181,0.4203125,0.3770833333333333,0.440625,0.47708333333333336
BloodImage_00393.jpg,350.jpg,RBC,398,290,519,416,1,121,126,458,353,0.715625,0.7354166666666667,0.1890625,0.2625
BloodImage_00393.jpg,350.jpg,RBC,141,240,275,366,1,134,126,208,303,0.325,0.63125,0.209375,0.2625
BloodImage_00393.jpg,350.jpg,RBC,1,189,120,278,1,119,89,60,233,0.09375,0.48541666666666666,0.1859375,0.18541666666666667
BloodImage_00393.jpg,350.jpg,RBC,1,373,86,480,1,85,107,43,426,0.0671875,0.8875,0.1328125,0.22291666666666668
BloodImage_00393.jpg,350.jpg,RBC,125,15,247,124,1,122,109,186,69,0.290625,0.14375,0.190625,0.22708333333333333
BloodImage_00393.jpg,350.jpg,RBC,105,122,227,231,1,122,109,166,176,0.259375,0.36666666666666664,0.190625,0.22708333333333333
BloodImage_00393.jpg,350.jpg,RBC,276,394,388,479,1,112,85,332,436,0.51875,0.9083333333333333,0.175,0.17708333333333334
BloodImage_00393.jpg,350.jpg,RBC,539,12,624,95,1,85,83,581,53,0.9078125,0.11041666666666666,0.1328125,0.17291666666666666
BloodImage_00393.jpg,350.jpg,RBC,354,20,485,134,1,131,114,419,77,0.6546875,0.16041666666666668,0.2046875,0.2375
BloodImage_00393.jpg,350.jpg,RBC,256,1,369,104,1,113,103,312,52,0.4875,0.10833333333333334,0.1765625,0.21458333333333332
BloodImage_00393.jpg,350.jpg,RBC,321,271,431,378,1,110,107,376,324,0.5875,0.675,0.171875,0.22291666666666668
BloodImage_00393.jpg,350.jpg,WBC,210,92,438,297,2,228,205,324,194,0.50625,0.4041666666666667,0.35625,0.4270833333333333
BloodImage_00395.jpg,351.jpg,RBC,25,90,127,209,1,102,119,76,149,0.11875,0.3104166666666667,0.159375,0.24791666666666667
BloodImage_00395.jpg,351.jpg,RBC,6,1,108,98,1,102,97,57,49,0.0890625,0.10208333333333333,0.159375,0.20208333333333334
BloodImage_00395.jpg,351.jpg,RBC,109,1,232,77,1,123,76,170,39,0.265625,0.08125,0.1921875,0.15833333333333333
BloodImage_00395.jpg,351.jpg,RBC,274,6,389,118,1,115,112,331,62,0.5171875,0.12916666666666668,0.1796875,0.23333333333333334
BloodImage_00395.jpg,351.jpg,RBC,364,173,479,289,1,115,116,421,231,0.6578125,0.48125,0.1796875,0.24166666666666667
BloodImage_00395.jpg,351.jpg,RBC,86,266,183,368,1,97,102,134,317,0.209375,0.6604166666666667,0.1515625,0.2125
BloodImage_00395.jpg,351.jpg,RBC,1,314,96,424,1,95,110,48,369,0.075,0.76875,0.1484375,0.22916666666666666
BloodImage_00395.jpg,351.jpg,RBC,177,331,273,441,1,96,110,225,386,0.3515625,0.8041666666666667,0.15,0.22916666666666666
BloodImage_00395.jpg,351.jpg,RBC,283,306,380,406,1,97,100,331,356,0.5171875,0.7416666666666667,0.1515625,0.20833333333333334
BloodImage_00395.jpg,351.jpg,RBC,392,296,504,397,1,112,101,448,346,0.7,0.7208333333333333,0.175,0.21041666666666667
BloodImage_00395.jpg,351.jpg,RBC,501,370,613,471,1,112,101,557,420,0.8703125,0.875,0.175,0.21041666666666667
BloodImage_00395.jpg,351.jpg,RBC,388,62,486,163,1,98,101,437,112,0.6828125,0.23333333333333334,0.153125,0.21041666666666667
BloodImage_00395.jpg,351.jpg,RBC,233,412,324,479,1,91,67,278,445,0.434375,0.9270833333333334,0.1421875,0.13958333333333334
BloodImage_00395.jpg,351.jpg,RBC,90,412,202,478,1,112,66,146,445,0.228125,0.9270833333333334,0.175,0.1375
BloodImage_00395.jpg,351.jpg,WBC,114,66,351,294,2,237,228,232,180,0.3625,0.375,0.3703125,0.475
BloodImage_00395.jpg,351.jpg,Platelets,472,201,540,268,0,68,67,506,234,0.790625,0.4875,0.10625,0.13958333333333334
BloodImage_00395.jpg,351.jpg,Platelets,470,43,516,84,0,46,41,493,63,0.7703125,0.13125,0.071875,0.08541666666666667
BloodImage_00396.jpg,352.jpg,RBC,474,110,596,231,1,122,121,535,170,0.8359375,0.3541666666666667,0.190625,0.2520833333333333
BloodImage_00396.jpg,352.jpg,RBC,429,259,537,382,1,108,123,483,320,0.7546875,0.6666666666666666,0.16875,0.25625
BloodImage_00396.jpg,352.jpg,RBC,121,141,214,245,1,93,104,167,193,0.2609375,0.40208333333333335,0.1453125,0.21666666666666667
BloodImage_00396.jpg,352.jpg,RBC,295,25,388,129,1,93,104,341,77,0.5328125,0.16041666666666668,0.1453125,0.21666666666666667
BloodImage_00396.jpg,352.jpg,RBC,471,1,572,102,1,101,101,521,51,0.8140625,0.10625,0.1578125,0.21041666666666667
BloodImage_00396.jpg,352.jpg,RBC,1,285,101,387,1,100,102,51,336,0.0796875,0.7,0.15625,0.2125
BloodImage_00396.jpg,352.jpg,RBC,163,236,264,338,1,101,102,213,287,0.3328125,0.5979166666666667,0.1578125,0.2125
BloodImage_00396.jpg,352.jpg,RBC,101,313,214,411,1,113,98,157,362,0.2453125,0.7541666666666667,0.1765625,0.20416666666666666
BloodImage_00396.jpg,352.jpg,RBC,213,321,326,419,1,113,98,269,370,0.4203125,0.7708333333333334,0.1765625,0.20416666666666666
BloodImage_00396.jpg,352.jpg,RBC,543,286,640,386,1,97,100,591,336,0.9234375,0.7,0.1515625,0.20833333333333334
BloodImage_00396.jpg,352.jpg,RBC,398,59,495,159,1,97,100,446,109,0.696875,0.22708333333333333,0.1515625,0.20833333333333334
BloodImage_00396.jpg,352.jpg,RBC,106,387,198,461,1,92,74,152,424,0.2375,0.8833333333333333,0.14375,0.15416666666666667
BloodImage_00396.jpg,352.jpg,RBC,2,20,129,120,1,127,100,65,70,0.1015625,0.14583333333333334,0.1984375,0.20833333333333334
BloodImage_00396.jpg,352.jpg,RBC,213,98,283,231,1,70,133,248,164,0.3875,0.3416666666666667,0.109375,0.27708333333333335
BloodImage_00396.jpg,352.jpg,RBC,347,357,449,460,1,102,103,398,408,0.621875,0.85,0.159375,0.21458333333333332
BloodImage_00396.jpg,352.jpg,RBC,16,174,118,277,1,102,103,67,225,0.1046875,0.46875,0.159375,0.21458333333333332
BloodImage_00396.jpg,352.jpg,RBC,539,402,640,480,1,101,78,589,441,0.9203125,0.91875,0.1578125,0.1625
BloodImage_00396.jpg,352.jpg,Platelets,437,426,492,479,0,55,53,464,452,0.725,0.9416666666666667,0.0859375,0.11041666666666666
BloodImage_00396.jpg,352.jpg,Platelets,302,400,337,423,0,35,23,319,411,0.4984375,0.85625,0.0546875,0.04791666666666667
BloodImage_00396.jpg,352.jpg,WBC,235,138,477,355,2,242,217,356,246,0.55625,0.5125,0.378125,0.45208333333333334
BloodImage_00397.jpg,353.jpg,RBC,68,154,165,249,1,97,95,116,201,0.18125,0.41875,0.1515625,0.19791666666666666
BloodImage_00397.jpg,353.jpg,RBC,1,145,66,260,1,65,115,33,202,0.0515625,0.42083333333333334,0.1015625,0.23958333333333334
BloodImage_00397.jpg,353.jpg,RBC,207,160,334,270,1,127,110,270,215,0.421875,0.4479166666666667,0.1984375,0.22916666666666666
BloodImage_00397.jpg,353.jpg,RBC,435,347,540,437,1,105,90,487,392,0.7609375,0.8166666666666667,0.1640625,0.1875
BloodImage_00397.jpg,353.jpg,RBC,535,356,639,464,1,104,108,587,410,0.9171875,0.8541666666666666,0.1625,0.225
BloodImage_00397.jpg,353.jpg,RBC,446,221,550,329,1,104,108,498,275,0.778125,0.5729166666666666,0.1625,0.225
BloodImage_00397.jpg,353.jpg,RBC,509,94,640,207,1,131,113,574,150,0.896875,0.3125,0.2046875,0.23541666666666666
BloodImage_00397.jpg,353.jpg,RBC,456,3,560,111,1,104,108,508,57,0.79375,0.11875,0.1625,0.225
BloodImage_00397.jpg,353.jpg,RBC,354,144,458,252,1,104,108,406,198,0.634375,0.4125,0.1625,0.225
BloodImage_00397.jpg,353.jpg,RBC,169,317,277,455,1,108,138,223,386,0.3484375,0.8041666666666667,0.16875,0.2875
BloodImage_00397.jpg,353.jpg,RBC,64,302,166,406,1,102,104,115,354,0.1796875,0.7375,0.159375,0.21666666666666667
BloodImage_00397.jpg,353.jpg,RBC,74,200,176,304,1,102,104,125,252,0.1953125,0.525,0.159375,0.21666666666666667
BloodImage_00397.jpg,353.jpg,RBC,141,18,217,109,1,76,91,179,63,0.2796875,0.13125,0.11875,0.18958333333333333
BloodImage_00397.jpg,353.jpg,RBC,316,47,409,141,1,93,94,362,94,0.565625,0.19583333333333333,0.1453125,0.19583333333333333
BloodImage_00397.jpg,353.jpg,RBC,356,1,465,56,1,109,55,410,28,0.640625,0.058333333333333334,0.1703125,0.11458333333333333
BloodImage_00397.jpg,353.jpg,RBC,35,65,128,159,1,93,94,81,112,0.1265625,0.23333333333333334,0.1453125,0.19583333333333333
BloodImage_00397.jpg,353.jpg,RBC,66,371,181,463,1,115,92,123,417,0.1921875,0.86875,0.1796875,0.19166666666666668
BloodImage_00397.jpg,353.jpg,WBC,247,352,462,480,2,215,128,354,416,0.553125,0.8666666666666667,0.3359375,0.26666666666666666
BloodImage_00398.jpg,354.jpg,RBC,1,260,89,378,1,88,118,45,319,0.0703125,0.6645833333333333,0.1375,0.24583333333333332
BloodImage_00398.jpg,354.jpg,RBC,72,105,182,229,1,110,124,127,167,0.1984375,0.34791666666666665,0.171875,0.25833333333333336
BloodImage_00398.jpg,354.jpg,RBC,340,215,429,318,1,89,103,384,266,0.6,0.5541666666666667,0.1390625,0.21458333333333332
BloodImage_00398.jpg,354.jpg,RBC,206,247,320,330,1,114,83,263,288,0.4109375,0.6,0.178125,0.17291666666666666
BloodImage_00398.jpg,354.jpg,RBC,287,311,409,412,1,122,101,348,361,0.54375,0.7520833333333333,0.190625,0.21041666666666667
BloodImage_00398.jpg,354.jpg,RBC,167,348,289,449,1,122,101,228,398,0.35625,0.8291666666666667,0.190625,0.21041666666666667
BloodImage_00398.jpg,354.jpg,RBC,351,6,447,103,1,96,97,399,54,0.6234375,0.1125,0.15,0.20208333333333334
BloodImage_00398.jpg,354.jpg,RBC,404,86,532,171,1,128,85,468,128,0.73125,0.26666666666666666,0.2,0.17708333333333334
BloodImage_00398.jpg,354.jpg,RBC,450,374,562,480,1,112,106,506,427,0.790625,0.8895833333333333,0.175,0.22083333333333333
BloodImage_00398.jpg,354.jpg,RBC,435,259,562,362,1,127,103,498,310,0.778125,0.6458333333333334,0.1984375,0.21458333333333332
BloodImage_00398.jpg,354.jpg,RBC,23,377,142,480,1,119,103,82,428,0.128125,0.8916666666666667,0.1859375,0.21458333333333332
BloodImage_00398.jpg,354.jpg,RBC,160,10,256,107,1,96,97,208,58,0.325,0.12083333333333333,0.15,0.20208333333333334
BloodImage_00398.jpg,354.jpg,RBC,509,147,605,244,1,96,97,557,195,0.8703125,0.40625,0.15,0.20208333333333334
BloodImage_00398.jpg,354.jpg,RBC,474,1,571,77,1,97,76,522,39,0.815625,0.08125,0.1515625,0.15833333333333333
BloodImage_00398.jpg,354.jpg,WBC,187,44,394,265,2,207,221,290,154,0.453125,0.32083333333333336,0.3234375,0.46041666666666664
BloodImage_00400.jpg,355.jpg,RBC,462,368,597,462,1,135,94,529,415,0.8265625,0.8645833333333334,0.2109375,0.19583333333333333
BloodImage_00400.jpg,355.jpg,RBC,376,104,510,208,1,134,104,443,156,0.6921875,0.325,0.209375,0.21666666666666667
BloodImage_00400.jpg,355.jpg,RBC,219,224,347,315,1,128,91,283,269,0.4421875,0.5604166666666667,0.2,0.18958333333333333
BloodImage_00400.jpg,355.jpg,RBC,124,286,222,390,1,98,104,173,338,0.2703125,0.7041666666666667,0.153125,0.21666666666666667
BloodImage_00400.jpg,355.jpg,RBC,69,393,174,479,1,105,86,121,436,0.1890625,0.9083333333333333,0.1640625,0.17916666666666667
BloodImage_00400.jpg,355.jpg,RBC,219,325,327,425,1,108,100,273,375,0.4265625,0.78125,0.16875,0.20833333333333334
BloodImage_00400.jpg,355.jpg,RBC,293,291,416,409,1,123,118,354,350,0.553125,0.7291666666666666,0.1921875,0.24583333333333332
BloodImage_00400.jpg,355.jpg,RBC,362,203,470,303,1,108,100,416,253,0.65,0.5270833333333333,0.16875,0.20833333333333334
BloodImage_00400.jpg,355.jpg,RBC,35,1,131,115,1,96,114,83,58,0.1296875,0.12083333333333333,0.15,0.2375
BloodImage_00400.jpg,355.jpg,RBC,461,195,561,296,1,100,101,511,245,0.7984375,0.5104166666666666,0.15625,0.21041666666666667
BloodImage_00400.jpg,355.jpg,RBC,374,1,482,100,1,108,99,428,50,0.66875,0.10416666666666667,0.16875,0.20625
BloodImage_00400.jpg,355.jpg,RBC,1,110,76,242,1,75,132,38,176,0.059375,0.36666666666666664,0.1171875,0.275
BloodImage_00400.jpg,355.jpg,WBC,117,18,355,235,2,238,217,236,126,0.36875,0.2625,0.371875,0.45208333333333334
BloodImage_00402.jpg,356.jpg,RBC,11,43,111,146,1,100,103,61,94,0.0953125,0.19583333333333333,0.15625,0.21458333333333332
BloodImage_00402.jpg,356.jpg,RBC,1,166,107,293,1,106,127,54,229,0.084375,0.47708333333333336,0.165625,0.26458333333333334
BloodImage_00402.jpg,356.jpg,RBC,93,327,189,425,1,96,98,141,376,0.2203125,0.7833333333333333,0.15,0.20416666666666666
BloodImage_00402.jpg,356.jpg,RBC,108,176,224,286,1,116,110,166,231,0.259375,0.48125,0.18125,0.22916666666666666
BloodImage_00402.jpg,356.jpg,RBC,221,41,337,151,1,116,110,279,96,0.4359375,0.2,0.18125,0.22916666666666666
BloodImage_00402.jpg,356.jpg,RBC,348,377,440,480,1,92,103,394,428,0.615625,0.8916666666666667,0.14375,0.21458333333333332
BloodImage_00402.jpg,356.jpg,RBC,171,377,271,480,1,100,103,221,428,0.3453125,0.8916666666666667,0.15625,0.21458333333333332
BloodImage_00402.jpg,356.jpg,RBC,329,147,447,250,1,118,103,388,198,0.60625,0.4125,0.184375,0.21458333333333332
BloodImage_00402.jpg,356.jpg,RBC,459,29,538,123,1,79,94,498,76,0.778125,0.15833333333333333,0.1234375,0.19583333333333333
BloodImage_00402.jpg,356.jpg,RBC,508,148,614,251,1,106,103,561,199,0.8765625,0.41458333333333336,0.165625,0.21458333333333332
BloodImage_00402.jpg,356.jpg,RBC,546,41,638,133,1,92,92,592,87,0.925,0.18125,0.14375,0.19166666666666668
BloodImage_00402.jpg,356.jpg,RBC,337,250,454,368,1,117,118,395,309,0.6171875,0.64375,0.1828125,0.24583333333333332
BloodImage_00402.jpg,356.jpg,RBC,262,135,362,232,1,100,97,312,183,0.4875,0.38125,0.15625,0.20208333333333334
BloodImage_00402.jpg,356.jpg,Platelets,296,243,341,291,0,45,48,318,267,0.496875,0.55625,0.0703125,0.1
BloodImage_00402.jpg,356.jpg,WBC,454,268,640,457,2,186,189,547,362,0.8546875,0.7541666666666667,0.290625,0.39375
BloodImage_00403.jpg,357.jpg,RBC,454,197,581,300,1,127,103,517,248,0.8078125,0.5166666666666667,0.1984375,0.21458333333333332
BloodImage_00403.jpg,357.jpg,RBC,303,284,374,389,1,71,105,338,336,0.528125,0.7,0.1109375,0.21875
BloodImage_00403.jpg,357.jpg,RBC,339,159,466,262,1,127,103,402,210,0.628125,0.4375,0.1984375,0.21458333333333332
BloodImage_00403.jpg,357.jpg,RBC,337,157,464,260,1,127,103,400,208,0.625,0.43333333333333335,0.1984375,0.21458333333333332
BloodImage_00403.jpg,357.jpg,RBC,323,120,407,201,1,84,81,365,160,0.5703125,0.3333333333333333,0.13125,0.16875
BloodImage_00403.jpg,357.jpg,RBC,234,84,361,187,1,127,103,297,135,0.4640625,0.28125,0.1984375,0.21458333333333332
BloodImage_00403.jpg,357.jpg,RBC,211,1,317,108,1,106,107,264,54,0.4125,0.1125,0.165625,0.22291666666666668
BloodImage_00403.jpg,357.jpg,RBC,1,14,90,122,1,89,108,45,68,0.0703125,0.14166666666666666,0.1390625,0.225
BloodImage_00403.jpg,357.jpg,RBC,1,138,63,239,1,62,101,32,188,0.05,0.39166666666666666,0.096875,0.21041666666666667
BloodImage_00403.jpg,357.jpg,RBC,210,336,316,444,1,106,108,263,390,0.4109375,0.8125,0.165625,0.225
BloodImage_00403.jpg,357.jpg,RBC,9,371,112,469,1,103,98,60,420,0.09375,0.875,0.1609375,0.20416666666666666
BloodImage_00403.jpg,357.jpg,RBC,11,272,114,370,1,103,98,62,321,0.096875,0.66875,0.1609375,0.20416666666666666
BloodImage_00403.jpg,357.jpg,RBC,78,368,183,449,1,105,81,130,408,0.203125,0.85,0.1640625,0.16875
BloodImage_00403.jpg,357.jpg,RBC,490,10,590,116,1,100,106,540,63,0.84375,0.13125,0.15625,0.22083333333333333
BloodImage_00403.jpg,357.jpg,RBC,556,126,640,197,1,84,71,598,161,0.934375,0.33541666666666664,0.13125,0.14791666666666667
BloodImage_00403.jpg,357.jpg,WBC,70,165,287,368,2,217,203,178,266,0.278125,0.5541666666666667,0.3390625,0.42291666666666666
BloodImage_00403.jpg,357.jpg,Platelets,369,260,431,325,0,62,65,400,292,0.625,0.6083333333333333,0.096875,0.13541666666666666
BloodImage_00403.jpg,357.jpg,Platelets,564,1,615,44,0,51,43,589,22,0.9203125,0.04583333333333333,0.0796875,0.08958333333333333
BloodImage_00404.jpg,358.jpg,RBC,398,196,529,282,1,131,86,463,239,0.7234375,0.4979166666666667,0.2046875,0.17916666666666667
BloodImage_00404.jpg,358.jpg,RBC,416,53,537,168,1,121,115,476,110,0.74375,0.22916666666666666,0.1890625,0.23958333333333334
BloodImage_00404.jpg,358.jpg,RBC,543,62,640,177,1,97,115,591,119,0.9234375,0.24791666666666667,0.1515625,0.23958333333333334
BloodImage_00404.jpg,358.jpg,RBC,279,43,383,147,1,104,104,331,95,0.5171875,0.19791666666666666,0.1625,0.21666666666666667
BloodImage_00404.jpg,358.jpg,RBC,188,355,292,447,1,104,92,240,401,0.375,0.8354166666666667,0.1625,0.19166666666666668
BloodImage_00404.jpg,358.jpg,RBC,284,348,360,434,1,76,86,322,391,0.503125,0.8145833333333333,0.11875,0.17916666666666667
BloodImage_00404.jpg,358.jpg,RBC,339,306,440,407,1,101,101,389,356,0.6078125,0.7416666666666667,0.1578125,0.21041666666666667
BloodImage_00404.jpg,358.jpg,RBC,397,344,522,433,1,125,89,459,388,0.7171875,0.8083333333333333,0.1953125,0.18541666666666667
BloodImage_00404.jpg,358.jpg,RBC,434,296,559,385,1,125,89,496,340,0.775,0.7083333333333334,0.1953125,0.18541666666666667
BloodImage_00404.jpg,358.jpg,RBC,1,364,93,468,1,92,104,47,416,0.0734375,0.8666666666666667,0.14375,0.21666666666666667
BloodImage_00404.jpg,358.jpg,RBC,70,71,190,157,1,120,86,130,114,0.203125,0.2375,0.1875,0.17916666666666667
BloodImage_00404.jpg,358.jpg,RBC,185,1,306,70,1,121,69,245,35,0.3828125,0.07291666666666667,0.1890625,0.14375
BloodImage_00404.jpg,358.jpg,RBC,574,179,640,288,1,66,109,607,233,0.9484375,0.48541666666666666,0.103125,0.22708333333333333
BloodImage_00404.jpg,358.jpg,WBC,115,134,363,369,2,248,235,239,251,0.3734375,0.5229166666666667,0.3875,0.4895833333333333
BloodImage_00404.jpg,358.jpg,Platelets,24,291,71,327,0,47,36,47,309,0.0734375,0.64375,0.0734375,0.075
BloodImage_00405.jpg,359.jpg,RBC,53,306,162,412,1,109,106,107,359,0.1671875,0.7479166666666667,0.1703125,0.22083333333333333
BloodImage_00405.jpg,359.jpg,RBC,1,203,68,322,1,67,119,34,262,0.053125,0.5458333333333333,0.1046875,0.24791666666666667
BloodImage_00405.jpg,359.jpg,RBC,162,114,271,220,1,109,106,216,167,0.3375,0.34791666666666665,0.1703125,0.22083333333333333
BloodImage_00405.jpg,359.jpg,RBC,110,82,221,197,1,111,115,165,139,0.2578125,0.28958333333333336,0.1734375,0.23958333333333334
BloodImage_00405.jpg,359.jpg,RBC,151,1,245,89,1,94,88,198,45,0.309375,0.09375,0.146875,0.18333333333333332
BloodImage_00405.jpg,359.jpg,RBC,243,1,337,89,1,94,88,290,45,0.453125,0.09375,0.146875,0.18333333333333332
BloodImage_00405.jpg,359.jpg,RBC,509,206,613,303,1,104,97,561,254,0.8765625,0.5291666666666667,0.1625,0.20208333333333334
BloodImage_00405.jpg,359.jpg,RBC,479,105,583,202,1,104,97,531,153,0.8296875,0.31875,0.1625,0.20208333333333334
BloodImage_00405.jpg,359.jpg,RBC,376,142,480,239,1,104,97,428,190,0.66875,0.3958333333333333,0.1625,0.20208333333333334
BloodImage_00405.jpg,359.jpg,RBC,238,235,360,338,1,122,103,299,286,0.4671875,0.5958333333333333,0.190625,0.21458333333333332
BloodImage_00405.jpg,359.jpg,RBC,176,212,291,315,1,115,103,233,263,0.3640625,0.5479166666666667,0.1796875,0.21458333333333332
BloodImage_00405.jpg,359.jpg,RBC,158,320,256,449,1,98,129,207,384,0.3234375,0.8,0.153125,0.26875
BloodImage_00405.jpg,359.jpg,RBC,307,336,378,455,1,71,119,342,395,0.534375,0.8229166666666666,0.1109375,0.24791666666666667
BloodImage_00405.jpg,359.jpg,RBC,316,1,451,153,1,135,152,383,77,0.5984375,0.16041666666666668,0.2109375,0.31666666666666665
BloodImage_00405.jpg,359.jpg,WBC,338,248,562,450,2,224,202,450,349,0.703125,0.7270833333333333,0.35,0.42083333333333334
BloodImage_00407.jpg,360.jpg,RBC,30,168,140,264,1,110,96,85,216,0.1328125,0.45,0.171875,0.2
BloodImage_00407.jpg,360.jpg,RBC,12,35,109,133,1,97,98,60,84,0.09375,0.175,0.1515625,0.20416666666666666
BloodImage_00407.jpg,360.jpg,RBC,25,352,137,452,1,112,100,81,402,0.1265625,0.8375,0.175,0.20833333333333334
BloodImage_00407.jpg,360.jpg,RBC,109,318,221,418,1,112,100,165,368,0.2578125,0.7666666666666667,0.175,0.20833333333333334
BloodImage_00407.jpg,360.jpg,RBC,158,240,273,361,1,115,121,215,300,0.3359375,0.625,0.1796875,0.2520833333333333
BloodImage_00407.jpg,360.jpg,RBC,248,346,345,441,1,97,95,296,393,0.4625,0.81875,0.1515625,0.19791666666666666
BloodImage_00407.jpg,360.jpg,RBC,350,292,453,382,1,103,90,401,337,0.6265625,0.7020833333333333,0.1609375,0.1875
BloodImage_00407.jpg,360.jpg,RBC,329,58,451,168,1,122,110,390,113,0.609375,0.23541666666666666,0.190625,0.22916666666666666
BloodImage_00407.jpg,360.jpg,RBC,170,1,300,101,1,130,100,235,51,0.3671875,0.10625,0.203125,0.20833333333333334
BloodImage_00407.jpg,360.jpg,RBC,168,110,277,203,1,109,93,222,156,0.346875,0.325,0.1703125,0.19375
BloodImage_00407.jpg,360.jpg,RBC,203,152,293,230,1,90,78,248,191,0.3875,0.39791666666666664,0.140625,0.1625
BloodImage_00407.jpg,360.jpg,RBC,388,1,538,76,1,150,75,463,38,0.7234375,0.07916666666666666,0.234375,0.15625
BloodImage_00407.jpg,360.jpg,RBC,524,221,637,301,1,113,80,580,261,0.90625,0.54375,0.1765625,0.16666666666666666
BloodImage_00407.jpg,360.jpg,RBC,470,122,553,205,1,83,83,511,163,0.7984375,0.33958333333333335,0.1296875,0.17291666666666666
BloodImage_00407.jpg,360.jpg,RBC,511,94,606,201,1,95,107,558,147,0.871875,0.30625,0.1484375,0.22291666666666668
BloodImage_00407.jpg,360.jpg,WBC,472,290,640,474,2,168,184,556,382,0.86875,0.7958333333333333,0.2625,0.38333333333333336
BloodImage_00407.jpg,360.jpg,Platelets,413,230,482,303,0,69,73,447,266,0.6984375,0.5541666666666667,0.1078125,0.15208333333333332
BloodImage_00407.jpg,360.jpg,Platelets,68,113,113,157,0,45,44,90,135,0.140625,0.28125,0.0703125,0.09166666666666666
BloodImage_00407.jpg,360.jpg,Platelets,112,25,164,64,0,52,39,138,44,0.215625,0.09166666666666666,0.08125,0.08125
BloodImage_00408.jpg,361.jpg,RBC,64,279,139,415,1,75,136,101,347,0.1578125,0.7229166666666667,0.1171875,0.2833333333333333
BloodImage_00408.jpg,361.jpg,RBC,118,120,232,219,1,114,99,175,169,0.2734375,0.35208333333333336,0.178125,0.20625
BloodImage_00408.jpg,361.jpg,RBC,1,178,92,277,1,91,99,46,227,0.071875,0.47291666666666665,0.1421875,0.20625
BloodImage_00408.jpg,361.jpg,RBC,213,304,316,404,1,103,100,264,354,0.4125,0.7375,0.1609375,0.20833333333333334
BloodImage_00408.jpg,361.jpg,RBC,215,391,313,480,1,98,89,264,435,0.4125,0.90625,0.153125,0.18541666666666667
BloodImage_00408.jpg,361.jpg,RBC,454,241,557,335,1,103,94,505,288,0.7890625,0.6,0.1609375,0.19583333333333333
BloodImage_00408.jpg,361.jpg,RBC,308,178,421,273,1,113,95,364,225,0.56875,0.46875,0.1765625,0.19791666666666666
BloodImage_00408.jpg,361.jpg,RBC,284,47,392,159,1,108,112,338,103,0.528125,0.21458333333333332,0.16875,0.23333333333333334
BloodImage_00408.jpg,361.jpg,RBC,470,1,574,68,1,104,67,522,34,0.815625,0.07083333333333333,0.1625,0.13958333333333334
BloodImage_00408.jpg,361.jpg,RBC,391,44,489,139,1,98,95,440,91,0.6875,0.18958333333333333,0.153125,0.19791666666666666
BloodImage_00408.jpg,361.jpg,RBC,387,136,480,253,1,93,117,433,194,0.6765625,0.4041666666666667,0.1453125,0.24375
BloodImage_00408.jpg,361.jpg,RBC,542,271,626,363,1,84,92,584,317,0.9125,0.6604166666666667,0.13125,0.19166666666666668
BloodImage_00408.jpg,361.jpg,RBC,9,28,105,135,1,96,107,57,81,0.0890625,0.16875,0.15,0.22291666666666668
BloodImage_00408.jpg,361.jpg,RBC,103,1,201,95,1,98,94,152,48,0.2375,0.1,0.153125,0.19583333333333333
BloodImage_00408.jpg,361.jpg,RBC,198,1,285,81,1,87,80,241,41,0.3765625,0.08541666666666667,0.1359375,0.16666666666666666
BloodImage_00408.jpg,361.jpg,Platelets,1,281,21,316,0,20,35,11,298,0.0171875,0.6208333333333333,0.03125,0.07291666666666667
BloodImage_00408.jpg,361.jpg,Platelets,383,254,424,284,0,41,30,403,269,0.6296875,0.5604166666666667,0.0640625,0.0625
BloodImage_00408.jpg,361.jpg,WBC,310,319,569,480,2,259,161,439,399,0.6859375,0.83125,0.4046875,0.33541666666666664
BloodImage_00409.jpg,362.jpg,RBC,518,168,611,268,1,93,100,564,218,0.88125,0.45416666666666666,0.1453125,0.20833333333333334
BloodImage_00409.jpg,362.jpg,RBC,426,87,551,198,1,125,111,488,142,0.7625,0.29583333333333334,0.1953125,0.23125
BloodImage_00409.jpg,362.jpg,RBC,502,298,611,411,1,109,113,556,354,0.86875,0.7375,0.1703125,0.23541666666666666
BloodImage_00409.jpg,362.jpg,RBC,250,245,371,357,1,121,112,310,301,0.484375,0.6270833333333333,0.1890625,0.23333333333333334
BloodImage_00409.jpg,362.jpg,RBC,58,104,170,215,1,112,111,114,159,0.178125,0.33125,0.175,0.23125
BloodImage_00409.jpg,362.jpg,RBC,378,258,504,368,1,126,110,441,313,0.6890625,0.6520833333333333,0.196875,0.22916666666666666
BloodImage_00409.jpg,362.jpg,RBC,228,126,320,217,1,92,91,274,171,0.428125,0.35625,0.14375,0.18958333333333333
BloodImage_00409.jpg,362.jpg,RBC,169,79,261,170,1,92,91,215,124,0.3359375,0.25833333333333336,0.14375,0.18958333333333333
BloodImage_00409.jpg,362.jpg,RBC,2,1,93,83,1,91,82,47,42,0.0734375,0.0875,0.1421875,0.17083333333333334
BloodImage_00409.jpg,362.jpg,RBC,16,229,121,313,1,105,84,68,271,0.10625,0.5645833333333333,0.1640625,0.175
BloodImage_00409.jpg,362.jpg,RBC,7,263,115,367,1,108,104,61,315,0.0953125,0.65625,0.16875,0.21666666666666667
BloodImage_00409.jpg,362.jpg,RBC,349,127,456,286,1,107,159,402,206,0.628125,0.42916666666666664,0.1671875,0.33125
BloodImage_00409.jpg,362.jpg,RBC,438,1,563,77,1,125,76,500,39,0.78125,0.08125,0.1953125,0.15833333333333333
BloodImage_00409.jpg,362.jpg,RBC,227,71,310,150,1,83,79,268,110,0.41875,0.22916666666666666,0.1296875,0.16458333333333333
BloodImage_00409.jpg,362.jpg,Platelets,413,396,456,433,0,43,37,434,414,0.678125,0.8625,0.0671875,0.07708333333333334
BloodImage_00409.jpg,362.jpg,Platelets,334,210,377,248,0,43,38,355,229,0.5546875,0.47708333333333336,0.0671875,0.07916666666666666
BloodImage_00409.jpg,362.jpg,Platelets,180,169,213,217,0,33,48,196,193,0.30625,0.40208333333333335,0.0515625,0.1
BloodImage_00409.jpg,362.jpg,Platelets,78,15,122,51,0,44,36,100,33,0.15625,0.06875,0.06875,0.075
BloodImage_00409.jpg,362.jpg,WBC,78,293,306,480,2,228,187,192,386,0.3,0.8041666666666667,0.35625,0.38958333333333334
BloodImage_00410.jpg,363.jpg,RBC,233,368,338,452,1,105,84,285,410,0.4453125,0.8541666666666666,0.1640625,0.175
BloodImage_00410.jpg,363.jpg,RBC,346,385,456,476,1,110,91,401,430,0.6265625,0.8958333333333334,0.171875,0.18958333333333333
BloodImage_00410.jpg,363.jpg,RBC,241,73,351,164,1,110,91,296,118,0.4625,0.24583333333333332,0.171875,0.18958333333333333
BloodImage_00410.jpg,363.jpg,RBC,250,1,366,85,1,116,84,308,43,0.48125,0.08958333333333333,0.18125,0.175
BloodImage_00410.jpg,363.jpg,RBC,106,315,226,428,1,120,113,166,371,0.259375,0.7729166666666667,0.1875,0.23541666666666666
BloodImage_00410.jpg,363.jpg,RBC,289,160,394,244,1,105,84,341,202,0.5328125,0.42083333333333334,0.1640625,0.175
BloodImage_00410.jpg,363.jpg,RBC,350,109,455,193,1,105,84,402,151,0.628125,0.3145833333333333,0.1640625,0.175
BloodImage_00410.jpg,363.jpg,RBC,104,20,209,104,1,105,84,156,62,0.24375,0.12916666666666668,0.1640625,0.175
BloodImage_00410.jpg,363.jpg,RBC,1,221,108,322,1,107,101,54,271,0.084375,0.5645833333333333,0.1671875,0.21041666666666667
BloodImage_00410.jpg,363.jpg,RBC,582,379,639,480,1,57,101,610,429,0.953125,0.89375,0.0890625,0.21041666666666667
BloodImage_00410.jpg,363.jpg,RBC,457,372,562,456,1,105,84,509,414,0.7953125,0.8625,0.1640625,0.175
BloodImage_00410.jpg,363.jpg,RBC,563,20,640,113,1,77,93,601,66,0.9390625,0.1375,0.1203125,0.19375
BloodImage_00410.jpg,363.jpg,RBC,304,262,400,387,1,96,125,352,324,0.55,0.675,0.15,0.2604166666666667
BloodImage_00410.jpg,363.jpg,Platelets,239,275,291,321,0,52,46,265,298,0.4140625,0.6208333333333333,0.08125,0.09583333333333334
BloodImage_00410.jpg,363.jpg,Platelets,121,260,189,320,0,68,60,155,290,0.2421875,0.6041666666666666,0.10625,0.125
BloodImage_00410.jpg,363.jpg,Platelets,57,119,104,167,0,47,48,80,143,0.125,0.29791666666666666,0.0734375,0.1
BloodImage_00410.jpg,363.jpg,Platelets,1,286,29,327,0,28,41,15,306,0.0234375,0.6375,0.04375,0.08541666666666667
BloodImage_00410.jpg,363.jpg,WBC,367,166,611,394,2,244,228,489,280,0.7640625,0.5833333333333334,0.38125,0.475
